Trial #9-------------------------

     A1    A2    A3    B1    B2    B3    C1    C2    C3    

A1   102   107   54    61    78    55    47    68    61    
     102   107   54    61    78    55    47    68    61    
     101   107   54    61    78    55    47    68    61    
     101   107   54    61    78    55    47    68    61    

bg   26    36    36    30    48    46    43    64    59    
     26    36    36    30    48    46    43    64    59    
     26    36    36    30    48    46    43    64    59    
     26    36    36    30    48    46    43    64    59    

A2   72    148   105   50    95    75    46    69    63    
     72    148   105   50    95    75    46    69    63    
     72    148   104   50    95    75    46    69    63    
     72    148   104   50    95    75    46    69    63    

bg   26    36    36    30    48    46    43    64    59    
     26    36    36    30    48    46    43    64    59    
     26    36    36    30    48    46    43    64    59    
     26    36    36    30    48    46    43    64    59    

A3   33    87    120   34    71    77    44    67    63    
     33    87    120   34    71    77    44    67    63    
     33    87    120   34    71    77    44    67    63    
     33    87    119   34    71    77    44    67    63    

bg   26    36    36    30    48    46    43    64    59    
     26    36    36    30    48    46    43    64    59    
     26    36    36    30    48    46    43    64    59    
     26    36    36    30    48    46    43    64    59    

B1   56    65    44    105   115   63    76    95    68    
     56    65    44    104   115   63    76    95    68    
     56    65    44    104   114   63    76    95    68    
     56    65    44    104   114   63    76    94    68    

bg   26    36    36    30    48    46    43    64    59    
     26    36    36    30    48    46    43    64    59    
     26    36    36    30    48    46    43    64    59    
     26    36    36    30    48    46    43    64    59    

B2   46    82    65    74    164   117   62    106   88    
     46    82    65    74    164   117   62    106   88    
     46    82    65    74    164   117   62    106   88    
     46    82    65    74    164   117   62    106   88    

bg   26    36    36    30    48    46    43    64    59    
     26    36    36    30    48    46    43    64    59    
     26    36    36    30    48    46    43    64    59    
     26    36    36    30    48    46    43    64    59    

B3   30    59    69    37    104   132   47    90    99    
     30    59    69    37    104   132   47    90    99    
     30    59    69    37    104   132   47    90    99    
     30    59    69    37    104   132   47    90    99    

bg   26    36    36    30    48    46    43    64    59    
     26    36    36    30    48    46    43    64    59    
     26    36    36    30    48    46    43    64    59    
     26    36    36    30    48    46    43    64    59    

C1   29    39    38    63    78    56    123   140   79    
     29    39    38    63    78    56    123   140   79    
     29    39    38    63    78    57    123   140   79    
     29    39    38    63    78    57    123   140   79    

bg   26    36    36    30    48    46    43    64    59    
     26    36    36    30    48    46    43    64    59    
     26    36    36    30    48    46    43    64    59    
     26    36    36    30    48    46    43    64    59    

C2   28    40    39    50    92    78    93    187   131   
     28    40    39    50    92    78    93    187   131   
     28    40    39    50    92    78    93    186   131   
     28    40    39    50    92    78    93    186   131   

bg   26    36    36    30    48    46    43    64    59    
     26    36    36    30    48    46    43    64    59    
     26    36    36    30    48    46    43    64    59    
     26    36    36    30    48    46    43    64    59    

C3   27    38    39    33    69    80    49    117   144   
     27    38    39    33    69    80    49    117   144   
     27    38    39    33    69    80    49    117   144   
     27    38    39    33    69    80    49    117   144   

bg   26    36    36    30    48    46    43    64    59    
     26    36    36    30    48    46    43    64    59    
     26    36    36    30    48    46    43    64    59    
     26    36    36    30    48    46    43    64    59    


Trial #10-------------------------

     A1    A2    A3    B1    B2    B3    C1    C2    C3    

A1   101   107   54    61    78    55    47    68    61    
     101   107   54    61    78    55    47    68    61    
     101   106   54    61    78    55    47    68    61    
     101   106   54    61    78    55    47    68    61    

bg   26    36    36    30    48    46    43    64    59    
     26    36    36    30    48    46    43    65    59    
     26    36    36    30    48    46    43    65    60    
     26    36    36    31    48    46    43    65    60    

A2   72    149   105   50    96    76    47    70    64    
     73    149   105   51    96    76    47    70    64    
     73    149   105   51    96    76    47    70    64    
     73    149   105   51    96    76    47    71    65    

bg   26    36    36    31    48    47    44    65    60    
     26    36    36    31    48    46    43    65    60    
     26    36    36    31    48    46    43    65    60    
     26    36    36    30    48    46    43    65    59    

A3   32    87    119   33    70    77    44    67    63    
     32    87    119   33    70    77    44    67    63    
     32    86    119   33    70    77    44    67    63    
     32    86    119   33    70    77    44    67    63    

bg   26    36    35    30    48    46    43    64    59    
     26    36    36    30    48    46    43    64    59    
     26    36    36    30    48    46    43    64    59    
     26    36    36    31    48    46    43    65    60    

B1   56    65    44    105   115   63    76    95    68    
     56    65    44    104   115   63    76    95    68    
     56    65    44    104   114   63    76    94    68    
     56    65    44    104   114   63    76    94    68    

bg   26    36    36    30    48    46    43    65    59    
     26    36    36    30    48    46    43    64    59    
     26    36    36    30    48    46    43    64    59    
     26    36    36    30    48    46    43    65    59    

B2   46    82    65    74    164   117   62    106   88    
     46    82    66    74    164   117   62    106   88    
     46    82    66    74    164   117   62    106   88    
     46    82    65    74    164   117   62    106   88    

bg   26    36    36    30    48    46    43    64    59    
     26    36    36    30    48    46    43    64    59    
     26    36    36    30    48    46    43    65    60    
     26    36    36    30    48    46    43    65    60    

B3   30    59    69    37    104   132   48    90    99    
     30    59    69    37    104   132   48    90    99    
     30    59    69    37    104   132   47    90    98    
     29    59    69    37    104   131   47    90    98    

bg   26    36    36    30    48    46    43    64    59    
     26    36    36    30    48    46    43    65    59    
     26    36    36    30    48    46    43    65    59    
     26    36    36    30    48    46    43    64    59    

C1   29    39    38    63    78    57    124   140   80    
     29    39    38    63    78    57    124   140   80    
     29    39    38    63    78    57    124   140   80    
     29    39    38    63    78    57    123   140   80    

bg   26    36    36    30    48    46    43    64    59    
     26    36    36    30    48    46    43    64    59    
     26    36    36    30    48    46    43    64    59    
     26    36    35    30    48    46    43    64    59    

C2   28    40    39    50    92    78    94    187   131   
     28    40    39    50    92    78    94    187   131   
     28    40    39    50    92    78    93    187   131   
     28    40    39    50    92    78    93    187   131   

bg   26    36    36    30    48    46    43    64    59    
     26    36    36    30    48    46    43    64    59    
     26    36    36    30    48    46    43    64    59    
     26    36    36    30    48    46    43    64    59    

C3   27    38    39    33    70    81    49    118   144   
     27    38    39    33    70    81    49    118   144   
     27    38    39    33    70    81    49    117   144   
     27    38    39    33    70    81    49    117   144   

bg   26    36    36    30    48    46    43    65    60    
     26    36    36    30    48    46    43    65    60    
     26    36    36    30    48    46    43    65    60    
     26    36    36    30    48    46    43    65    60    


Trial #11-------------------------

     A1    A2    A3    B1    B2    B3    C1    C2    C3    

A1   101   107   54    61    78    55    47    68    61    
     101   107   54    61    78    55    47    68    61    
     101   106   54    61    78    55    47    68    61    
     101   106   54    61    78    55    47    68    62    

bg   26    36    36    30    48    46    43    64    59    
     26    36    36    30    48    46    43    64    59    
     26    36    36    30    48    46    43    64    59    
     26    36    36    30    48    46    43    64    59    

A2   72    149   105   50    95    75    46    69    63    
     72    149   105   50    95    75    46    69    63    
     72    149   105   50    95    75    46    69    63    
     72    149   105   50    95    75    46    69    63    

bg   26    36    36    30    48    46    43    64    59    
     26    36    36    30    48    46    43    64    59    
     26    36    36    30    48    46    43    64    59    
     26    36    36    30    48    46    43    64    59    

A3   32    87    119   33    71    77    44    67    63    
     32    87    119   34    71    77    44    67    63    
     32    87    119   34    71    77    44    67    63    
     32    87    119   34    71    77    44    67    63    

bg   26    36    36    30    48    46    43    65    60    
     26    36    36    30    48    46    43    65    60    
     26    36    36    30    48    46    43    64    59    
     26    36    36    30    48    46    43    64    59    

B1   56    65    44    105   115   63    76    95    68    
     56    65    44    105   115   64    76    95    68    
     56    65    44    105   115   63    76    95    68    
     56    65    44    104   115   63    76    95    68    

bg   26    36    36    30    48    46    43    64    59    
     26    36    36    30    48    46    43    64    59    
     26    36    36    30    48    46    43    65    59    
     26    36    36    30    48    46    43    65    59    

B2   46    82    65    74    164   117   62    106   88    
     46    82    65    74    164   117   62    106   88    
     46    82    66    74    164   117   62    106   88    
     46    82    66    74    164   117   62    106   88    

bg   26    36    36    30    48    46    43    65    60    
     26    36    36    31    48    46    43    65    60    
     26    36    36    31    48    46    43    65    60    
     26    36    36    31    48    46    43    65    60    

B3   30    59    69    37    104   132   48    90    99    
     30    59    69    37    104   132   47    90    99    
     30    59    69    37    104   132   47    90    99    
     30    59    69    37    104   132   47    90    99    

bg   26    36    36    30    48    46    43    65    60    
     26    36    36    30    48    46    43    65    60    
     26    36    36    30    48    46    43    65    60    
     26    36    36    30    48    46    43    65    60    

C1   29    39    38    63    78    57    124   141   80    
     29    39    38    63    78    57    124   141   80    
     29    39    37    63    78    56    124   140   79    
     29    39    37    63    78    57    124   140   79    

bg   26    36    36    30    48    46    43    65    59    
     26    36    36    30    48    46    43    65    59    
     26    36    36    30    48    46    43    65    59    
     26    36    36    30    48    46    43    64    59    

C2   28    40    39    50    92    78    94    188   131   
     28    40    39    50    92    78    94    187   131   
     28    40    39    50    93    78    94    187   131   
     28    40    39    50    92    78    94    187   131   

bg   26    36    36    30    48    46    43    65    59    
     26    36    36    30    48    46    43    65    60    
     26    36    36    30    48    46    43    65    60    
     26    36    36    30    48    46    43    65    60    

C3   27    38    39    34    70    81    49    118   145   
     27    38    39    34    70    81    49    118   145   
     27    38    39    34    70    81    49    118   145   
     27    38    39    34    70    81    49    118   144   

bg   26    36    36    30    48    46    43    65    59    
     26    36    36    30    48    46    43    65    59    
     26    36    36    30    48    46    43    65    60    
     26    36    36    30    48    46    43    65    60    


Trial #12-------------------------

     A1    A2    A3    B1    B2    B3    C1    C2    C3    

A1   101   107   54    61    78    55    47    68    62    
     101   107   54    61    78    55    47    68    61    
     101   106   54    61    78    55    47    68    61    
     101   106   54    61    78    55    47    68    61    

bg   26    36    36    30    48    46    43    64    59    
     26    36    36    30    48    46    43    65    59    
     26    36    36    30    48    46    43    65    60    
     26    36    36    30    48    46    43    65    60    

A2   72    149   105   50    96    76    46    69    63    
     72    149   105   50    96    76    46    69    63    
     72    149   105   50    96    76    46    69    63    
     72    149   105   50    96    75    46    69    63    

bg   26    36    36    31    48    46    43    65    60    
     26    36    36    31    48    47    44    65    60    
     26    36    36    31    48    47    44    65    60    
     26    36    36    31    49    47    44    66    60    

A3   33    88    120   34    72    78    46    69    65    
     33    88    120   34    72    78    46    69    65    
     33    87    120   34    72    78    45    68    65    
     33    87    120   34    71    78    45    68    64    

bg   26    36    36    30    48    46    43    65    59    
     26    36    36    30    48    46    43    64    59    
     26    36    35    30    48    46    43    64    59    
     26    36    35    30    48    46    43    64    59    

B1   55    64    43    104   114   63    75    94    68    
     55    64    44    104   114   63    75    94    68    
     55    64    44    104   114   63    76    94    68    
     56    65    44    104   114   63    76    94    68    

bg   26    36    36    30    48    46    43    65    60    
     26    36    36    30    48    46    43    65    60    
     26    36    36    30    48    46    43    65    60    
     26    36    36    30    48    46    43    65    60    

B2   46    82    65    74    164   117   62    106   88    
     46    82    65    73    164   117   62    106   88    
     46    82    65    73    164   117   62    106   88    
     46    82    65    73    164   117   62    106   88    

bg   26    36    36    30    48    46    43    64    59    
     26    36    36    30    48    46    43    64    59    
     26    36    35    30    48    46    43    64    59    
     26    36    35    30    48    46    43    64    59    

B3   29    59    69    37    104   132   47    90    98    
     29    59    69    37    104   132   47    90    98    
     29    59    69    37    104   132   47    90    98    
     29    59    69    37    104   132   47    90    98    

bg   26    36    36    30    48    46    43    65    59    
     26    36    35    30    48    46    43    64    59    
     26    36    35    30    48    46    43    64    59    
     26    36    35    30    48    46    43    64    59    

C1   29    39    37    63    78    56    123   140   79    
     29    39    37    63    78    57    123   140   79    
     29    39    37    63    78    57    123   140   79    
     29    39    37    63    78    57    123   140   79    

bg   26    36    36    30    48    46    43    65    59    
     26    36    36    30    48    46    43    64    59    
     26    36    36    30    48    46    43    65    59    
     26    36    36    30    48    46    43    65    59    

C2   28    40    39    50    93    78    94    188   132   
     28    40    39    50    93    78    94    188   132   
     28    40    39    50    93    78    94    188   132   
     28    40    39    50    93    78    94    188   132   

bg   26    36    36    31    48    46    43    65    60    
     26    36    36    31    48    46    43    65    60    
     26    36    36    31    48    46    43    65    60    
     26    36    36    31    48    46    43    65    60    

C3   27    39    39    34    70    81    50    118   145   
     27    39    39    34    70    81    50    118   145   
     27    39    39    34    70    81    49    118   145   
     27    38    39    34    70    81    49    118   144   

bg   26    36    36    30    48    46    43    64    59    
     26    36    36    30    48    46    43    64    59    
     26    36    36    30    48    46    43    65    59    
     26    36    36    30    48    46    43    65    60    

