Trial #9-------------------------

     A1    A2    A3    B1    B2    B3    C1    C2    C3    

A1   89    90    38    47    56    34    27    38    34    
     89    90    38    47    56    34    27    38    34    
     88    89    38    46    56    34    27    38    34    
     88    89    38    46    56    34    27    38    34    

bg   14    19    19    16    26    25    23    34    32    
     14    19    19    16    26    25    23    34    32    
     14    19    19    16    26    25    23    34    32    
     14    19    19    16    26    25    23    34    32    

A2   60    132   88    36    73    54    26    39    36    
     60    132   88    36    73    54    26    39    36    
     60    132   88    36    73    54    26    39    36    
     60    132   88    36    73    54    26    39    36    

bg   14    19    19    16    26    25    23    34    32    
     14    19    19    16    26    25    23    34    32    
     14    19    19    16    26    25    23    34    32    
     14    19    19    16    26    25    23    34    32    

A3   21    70    103   19    49    56    24    37    36    
     21    70    103   19    49    56    24    37    36    
     21    70    103   19    49    56    24    37    36    
     21    70    103   19    49    56    24    37    36    

bg   14    19    19    16    26    25    23    34    32    
     14    19    19    16    26    25    23    34    32    
     14    19    19    16    26    25    23    34    32    
     14    19    19    16    26    25    23    34    32    

B1   44    48    27    90    92    42    55    64    41    
     44    48    27    90    92    42    55    64    41    
     44    48    27    90    92    42    55    64    41    
     44    48    27    90    92    42    55    64    41    

bg   14    19    19    16    26    25    23    34    32    
     14    19    19    16    26    25    23    34    32    
     14    19    19    16    26    25    23    34    32    
     14    19    19    16    26    25    23    34    32    

B2   34    66    49    59    142   96    42    76    61    
     34    66    49    59    142   96    42    76    61    
     34    66    49    59    142   96    42    76    61    
     34    66    49    59    142   96    42    76    61    

bg   14    19    19    16    26    25    23    34    32    
     14    19    19    16    26    25    23    34    32    
     14    19    19    16    26    25    23    34    32    
     14    19    19    16    26    25    23    34    32    

B3   18    43    53    23    82    111   27    60    71    
     18    43    53    23    82    111   27    60    71    
     18    43    53    23    82    111   27    60    71    
     18    43    53    23    82    111   27    60    71    

bg   14    20    20    17    26    26    23    35    33    
     14    20    20    17    26    26    23    35    33    
     14    20    20    16    26    25    23    35    32    
     14    19    19    16    26    25    23    35    32    

C1   17    23    21    48    56    35    103   110   52    
     17    23    21    48    56    35    103   110   52    
     17    23    21    48    56    35    103   110   52    
     17    23    21    48    56    36    102   110   52    

bg   14    19    19    16    26    25    23    34    32    
     14    19    19    16    26    25    23    34    32    
     14    19    19    16    26    25    23    34    32    
     14    19    19    16    26    25    23    34    32    

C2   16    23    22    36    71    57    74    157   104   
     16    23    22    36    71    57    74    157   104   
     16    23    22    36    71    57    74    157   104   
     16    23    22    36    71    57    74    157   104   

bg   14    19    19    16    26    25    23    34    32    
     14    19    19    16    26    25    23    34    32    
     14    19    19    16    26    25    23    34    32    
     14    19    19    16    26    25    23    35    32    

C3   15    22    23    19    48    60    29    88    117   
     15    22    23    19    48    60    29    88    117   
     15    22    23    19    48    60    29    88    117   
     15    22    23    19    48    60    29    88    117   

bg   14    19    19    16    26    25    23    35    32    
     14    19    19    16    26    25    23    35    32    
     14    19    19    16    26    25    23    35    32    
     14    19    19    16    26    25    23    35    32    


Trial #10-------------------------

     A1    A2    A3    B1    B2    B3    C1    C2    C3    

A1   89    90    38    47    56    34    27    38    34    
     89    90    38    47    56    34    27    38    34    
     89    90    38    47    56    34    27    38    34    
     88    89    38    46    56    34    27    38    34    

bg   14    19    19    16    26    25    23    35    32    
     14    19    19    16    26    25    23    35    32    
     14    19    19    16    26    25    23    35    32    
     14    19    19    16    26    25    23    35    32    

A2   60    132   89    36    73    54    26    39    36    
     60    132   89    36    73    54    26    39    36    
     60    132   89    36    73    54    26    39    36    
     60    132   88    36    73    54    26    39    36    

bg   14    19    19    16    26    25    23    35    32    
     14    19    19    16    26    25    23    34    32    
     14    19    19    16    26    25    23    35    32    
     14    19    19    16    26    25    23    34    32    

A3   21    71    103   19    49    56    24    37    36    
     21    71    103   19    49    56    24    37    36    
     21    70    103   19    49    56    24    37    36    
     21    70    103   19    49    56    24    37    36    

bg   14    19    19    16    26    25    23    35    32    
     14    19    19    16    26    25    23    35    32    
     14    19    19    16    26    25    23    35    32    
     14    19    19    16    26    25    23    35    32    

B1   44    48    28    90    92    42    55    65    41    
     44    48    28    90    92    42    55    64    41    
     44    48    28    90    92    42    55    64    41    
     44    48    28    90    92    42    55    64    41    

bg   14    19    19    16    26    25    23    35    32    
     14    19    19    16    26    25    23    34    32    
     14    19    19    16    26    25    23    34    32    
     14    19    19    16    26    25    23    34    32    

B2   34    66    49    59    142   96    42    76    61    
     34    66    49    59    142   96    42    76    61    
     34    66    49    59    141   96    42    76    61    
     34    66    49    59    141   96    42    76    61    

bg   14    19    20    16    26    25    23    35    32    
     14    20    20    16    26    25    23    35    32    
     14    20    20    16    26    26    23    35    32    
     14    20    20    16    26    26    23    35    32    

B3   18    43    53    23    82    112   27    60    71    
     18    43    53    23    82    111   27    60    71    
     18    43    53    23    82    111   27    60    71    
     18    43    53    23    82    111   27    60    71    

bg   14    20    20    17    26    26    23    35    33    
     14    20    20    17    26    26    23    35    33    
     14    20    20    16    26    26    23    35    32    
     14    20    20    16    26    26    23    35    32    

C1   17    23    22    49    56    36    103   111   52    
     17    23    22    49    56    36    103   111   52    
     17    23    22    49    56    36    103   110   52    
     17    23    22    49    56    36    103   110   52    

bg   14    19    19    16    26    25    23    34    32    
     14    19    19    16    26    25    23    34    32    
     14    19    19    16    26    25    23    35    32    
     14    19    19    16    26    25    23    35    32    

C2   16    23    23    36    71    57    74    158   104   
     16    24    23    36    71    57    74    158   104   
     16    23    23    36    71    57    74    158   104   
     16    24    23    36    71    57    74    158   104   

bg   14    19    20    16    26    25    23    35    32    
     14    19    20    16    26    25    23    35    32    
     14    19    20    16    26    25    23    35    32    
     14    19    20    16    26    25    23    35    32    

C3   15    22    23    19    48    60    29    88    117   
     15    22    23    19    48    60    29    88    117   
     15    22    23    20    48    60    29    88    117   
     15    22    23    20    48    60    29    88    117   

bg   14    20    20    16    26    26    23    35    32    
     14    20    20    16    26    26    23    35    32    
     14    20    20    16    26    25    23    35    32    
     14    20    20    16    26    25    23    35    32    


Trial #11-------------------------

     A1    A2    A3    B1    B2    B3    C1    C2    C3    

A1   89    90    38    47    56    34    27    38    34    
     89    90    38    47    56    34    27    38    34    
     89    90    38    47    56    34    27    38    34    
     88    90    38    46    56    34    27    38    34    

bg   14    19    19    16    26    25    23    34    32    
     14    19    19    16    26    25    23    34    32    
     14    19    19    16    26    25    23    34    32    
     14    19    19    16    26    25    23    35    32    

A2   60    132   89    36    73    54    26    39    36    
     60    132   89    36    73    54    26    39    36    
     60    132   89    36    73    54    26    39    36    
     60    132   88    36    73    54    26    39    36    

bg   14    19    19    16    26    25    23    35    32    
     14    19    19    16    26    25    23    35    32    
     14    19    19    16    26    25    23    35    32    
     14    19    20    16    26    25    23    35    32    

A3   21    70    103   20    49    56    24    37    36    
     21    70    103   20    49    56    24    37    36    
     21    71    103   20    49    56    25    38    37    
     21    71    103   20    49    56    25    38    37    

bg   14    20    20    17    26    26    23    35    33    
     14    20    20    17    26    26    23    35    33    
     14    20    20    16    26    26    23    35    32    
     14    20    20    16    26    25    23    35    32    

B1   44    48    28    90    93    42    56    65    41    
     44    48    28    90    92    42    55    65    41    
     44    48    28    90    92    42    55    64    41    
     44    48    28    90    92    42    55    64    41    

bg   14    19    20    16    26    25    23    35    32    
     14    20    20    16    26    25    23    35    32    
     14    20    20    16    26    25    23    35    32    
     14    20    20    16    26    26    23    35    32    

B2   34    66    50    60    143   97    42    77    61    
     35    66    50    60    142   96    42    77    61    
     35    66    50    60    142   96    42    77    61    
     35    66    50    59    142   96    42    77    61    

bg   14    20    20    16    26    25    23    35    32    
     14    19    20    16    26    25    23    35    32    
     14    19    20    16    26    25    23    35    32    
     14    19    19    16    26    25    23    35    32    

B3   18    43    53    23    82    111   27    60    71    
     18    43    53    23    82    111   27    60    71    
     18    43    53    23    82    111   27    60    71    
     18    43    53    23    82    111   27    60    71    

bg   14    19    20    16    26    25    23    35    32    
     14    19    20    16    26    25    23    35    32    
     14    19    20    16    26    25    23    35    32    
     14    19    20    16    26    25    23    35    32    

C1   17    23    22    49    56    36    103   111   52    
     17    23    21    49    56    36    103   110   52    
     17    23    21    49    56    36    103   110   52    
     17    23    21    49    56    36    103   110   52    

bg   14    19    20    16    26    25    23    35    32    
     14    19    20    16    26    25    23    35    32    
     14    19    20    16    26    25    23    35    32    
     14    19    20    16    26    25    23    35    32    

C2   16    24    23    36    71    58    74    158   105   
     16    24    23    36    71    58    74    158   105   
     16    24    23    36    71    58    74    158   105   
     16    24    23    36    71    58    74    158   105   

bg   14    20    20    16    26    26    23    35    33    
     14    20    20    16    26    26    23    35    32    
     14    20    20    16    26    25    23    35    32    
     14    20    20    16    26    25    23    35    32    

C3   15    22    23    19    48    59    29    88    116   
     15    22    23    19    48    60    29    88    117   
     15    22    23    19    48    60    29    88    117   
     15    22    23    19    48    60    29    88    117   

bg   14    20    20    16    26    26    23    35    33    
     14    20    20    17    26    26    23    35    33    
     14    20    20    17    27    26    24    36    33    
     14    20    20    17    27    26    24    36    33    


Trial #12-------------------------

     A1    A2    A3    B1    B2    B3    C1    C2    C3    

A1   90    91    38    47    56    34    27    38    34    
     89    90    38    47    56    34    27    38    34    
     89    90    38    47    56    34    27    38    34    
     89    90    38    47    56    34    27    38    34    

bg   14    19    20    16    26    25    23    35    32    
     14    19    20    16    26    25    23    35    32    
     14    20    20    16    26    25    23    35    32    
     14    19    20    16    26    25    23    35    32    

A2   60    132   88    36    73    54    26    39    36    
     60    132   88    36    73    54    26    39    36    
     60    131   88    36    73    54    26    39    36    
     60    131   88    36    73    54    26    39    36    

bg   14    20    20    16    26    25    23    35    32    
     14    20    20    16    26    25    23    35    32    
     14    20    20    16    26    25    23    35    32    
     14    20    20    16    26    25    23    35    32    

A3   21    71    103   20    49    56    24    37    36    
     21    71    103   20    49    56    24    37    36    
     21    71    103   20    49    56    24    37    36    
     21    70    103   20    49    56    24    37    36    

bg   14    20    20    16    26    25    23    35    32    
     14    20    20    16    26    25    23    35    32    
     14    20    20    16    26    25    23    35    32    
     14    20    20    16    26    25    23    35    32    

B1   44    49    28    91    93    43    56    65    41    
     44    49    28    90    93    43    56    65    41    
     44    49    28    90    93    43    56    65    41    
     44    49    28    90    93    43    56    65    41    

bg   14    20    20    16    26    25    23    35    32    
     14    20    20    16    26    25    23    35    32    
     14    20    20    16    26    25    23    35    32    
     14    20    20    16    26    25    23    35    32    

B2   34    66    49    59    142   96    42    76    61    
     34    66    49    59    142   96    42    76    61    
     34    66    49    59    142   96    42    76    61    
     34    66    50    59    142   96    42    76    61    

bg   14    20    20    16    26    25    23    35    32    
     14    20    20    16    26    25    23    35    32    
     14    20    20    16    26    25    23    35    32    
     14    20    20    16    26    25    23    35    32    

B3   18    43    53    23    82    112   27    61    72    
     18    43    53    23    82    111   27    60    71    
     18    43    53    23    82    111   27    60    71    
     18    43    53    23    82    111   28    60    71    

bg   14    20    20    16    26    25    23    35    32    
     14    20    20    16    26    25    23    35    32    
     14    20    20    16    26    25    23    35    32    
     14    20    20    16    26    25    23    35    32    

C1   17    23    22    49    56    36    104   111   52    
     17    23    22    49    56    36    103   111   52    
     17    23    22    49    56    36    103   111   52    
     17    23    22    49    56    36    103   111   52    

bg   14    20    20    16    26    26    23    35    32    
     14    20    20    17    26    26    23    35    33    
     14    20    20    17    26    26    23    35    33    
     14    20    20    17    26    26    23    35    33    

C2   17    24    23    36    71    58    74    158   104   
     17    24    23    36    71    58    74    158   104   
     17    24    23    36    71    58    74    158   104   
     17    24    23    36    71    58    74    157   104   

bg   14    20    20    17    26    26    23    35    33    
     14    20    20    17    26    26    23    35    33    
     14    20    20    17    26    26    23    35    33    
     14    20    20    17    26    26    23    35    33    

C3   16    22    23    20    48    60    29    89    118   
     16    22    23    20    48    60    29    89    118   
     15    22    23    20    48    60    29    89    118   
     15    22    23    20    48    60    29    88    118   

bg   14    20    20    16    26    26    23    35    32    
     14    20    20    16    26    26    23    35    32    
     14    20    20    16    26    26    23    35    32    
     14    20    20    16    26    26    23    35    32    

