     A1    A2    A3    B1    B2    B3    C1    C2    C3    

A1   136   153   102   107   152   124   120   170   152   
     136   152   102   106   151   123   119   168   151   
     135   152   102   106   150   123   119   167   150   
     135   151   101   105   149   122   118   166   150   

bg   66    91    87    79    125   115   114   163   147   
     66    91    87    79    126   116   114   163   147   
     66    92    88    80    126   116   114   164   148   
     66    92    88    80    126   116   115   164   148   

A2   108   202   156   97    169   143   117   167   150   
     109   203   156   97    170   143   117   168   151   
     109   203   156   98    170   144   118   169   152   
     109   203   157   98    171   145   118   169   152   

bg   67    93    89    81    127   117   116   165   150   
     66    92    88    80    127   116   115   164   149   
     66    92    88    80    127   117   115   165   149   
     67    93    89    81    128   117   116   166   150   

A3   74    147   170   85    153   150   118   170   155   
     74    147   170   85    153   150   118   169   155   
     73    146   168   84    151   148   116   167   153   
     73    145   168   83    150   147   116   166   152   

bg   66    92    88    80    126   116   115   164   148   
     66    92    88    80    126   116   115   164   148   
     66    92    88    80    127   116   115   164   149   
     66    92    88    80    127   116   115   164   149   

B1   97    119   95    154   191   132   149   194   156   
     97    119   95    154   191   132   149   194   156   
     97    120   95    155   192   133   150   195   157   
     97    119   95    154   192   133   150   195   157   

bg   68    94    90    82    129   119   117   168   152   
     67    93    89    81    128   117   116   166   150   
     66    92    88    80    126   116   114   164   148   
     66    92    89    80    127   117   115   165   149   

B2   84    133   114   120   236   183   135   206   175   
     84    133   114   119   236   183   135   206   175   
     84    133   114   119   236   183   135   206   175   
     84    133   114   119   235   182   135   205   175   

bg   67    92    88    80    127   117   115   165   149   
     67    93    88    81    127   117   115   165   149   
     66    92    88    80    126   116   115   164   148   
     66    92    88    80    126   116   114   164   148   

B3   69    111   115   85    176   193   119   188   182   
     69    110   115   85    176   193   118   187   182   
     69    111   115   85    176   193   119   188   182   
     69    111   116   85    177   193   120   189   183   

bg   66    92    88    80    127   116   115   164   149   
     66    92    88    80    127   116   115   164   149   
     67    93    88    81    127   117   115   165   149   
     66    92    88    80    127   117   115   164   149   

C1   70    95    89    113   158   127   194   234   169   
     70    96    90    113   159   127   194   235   170   
     70    95    90    113   158   127   194   234   170   
     70    95    90    113   159   127   194   234   170   

bg   66    92    88    80    126   116   115   164   149   
     66    92    88    80    126   116   115   164   149   
     66    92    88    80    127   116   115   164   148   
     66    92    88    80    126   116   115   164   149   

C2   69    96    91    101   173   147   165   270   213   
     69    96    91    101   174   148   165   271   214   
     69    97    92    101   174   148   166   272   214   
     69    97    92    101   175   149   166   272   215   

bg   66    92    88    80    126   116   114   163   148   
     66    92    88    80    126   116   114   164   148   
     66    92    88    80    126   116   114   164   148   
     66    92    88    80    126   116   115   164   149   

C3   67    94    91    83    149   147   122   213   221   
     67    94    90    83    149   147   122   213   220   
     67    94    91    83    149   148   122   213   221   
     67    95    91    83    149   148   122   214   221   

bg   66    92    88    80    126   116   114   164   148   
     66    92    88    80    126   116   114   164   148   
     66    92    88    80    126   116   114   164   148   
     67    93    88    81    127   117   115   165   150   
