     A1    A2    A3    B1    B2    B3    C1    C2    C3    

A1   135   152   101   106   150   122   118   167   150   
     135   152   101   106   150   122   118   167   150   
     135   151   101   106   149   122   118   166   150   
     135   152   101   106   150   122   118   167   150   

bg   66    92    88    80    126   116   115   164   148   
     66    92    88    80    127   117   115   165   149   
     67    93    88    81    127   117   115   165   150   
     67    92    88    80    127   117   115   165   149   

A2   109   204   157   98    171   145   118   169   153   
     109   203   157   98    170   144   118   169   152   
     109   203   156   97    170   143   117   168   151   
     109   203   156   98    170   144   117   168   151   

bg   66    92    87    80    126   115   114   163   148   
     66    92    88    80    126   116   114   164   148   
     66    92    88    80    126   116   114   164   148   
     66    92    88    80    126   116   114   164   148   

A3   73    146   169   84    151   148   116   167   153   
     73    146   169   84    151   148   116   167   153   
     73    146   168   84    151   148   116   167   153   
     73    146   169   84    152   148   117   168   153   

bg   67    93    89    81    128   117   116   166   150   
     67    93    89    81    129   118   117   167   151   
     66    92    88    80    127   116   115   164   149   
     66    92    88    80    126   116   114   164   148   

B1   96    118   94    153   190   132   148   193   156   
     97    119   95    154   191   132   149   194   156   
     97    119   95    154   191   132   149   194   157   
     97    120   96    155   192   133   150   195   158   

bg   68    95    90    82    130   120   118   169   153   
     67    93    90    82    128   117   116   166   151   
     66    92    88    80    127   116   115   164   149   
     66    92    88    80    127   116   115   164   149   

B2   84    133   114   119   236   183   135   206   175   
     84    133   114   119   236   183   135   206   175   
     84    133   115   120   236   183   135   206   176   
     84    133   115   120   236   183   135   207   176   

bg   66    91    87    80    126   115   114   163   148   
     66    92    88    80    127   116   115   164   149   
     67    93    89    81    128   117   116   166   150   
     68    94    90    82    129   119   117   168   152   

B3   68    110   115   84    175   192   118   186   181   
     69    110   115   84    175   192   118   187   181   
     69    111   116   85    177   193   119   189   182   
     70    113   117   87    179   195   121   191   185   

bg   66    92    88    80    126   116   114   164   148   
     66    92    87    80    126   115   114   163   148   
     66    92    88    80    126   116   114   164   148   
     66    92    88    80    126   116   114   164   148   

C1   70    96    90    113   159   127   195   235   170   
     70    95    90    113   159   127   194   235   170   
     70    95    90    113   159   127   194   235   170   
     70    96    90    113   159   127   194   235   170   

bg   66    91    87    79    125   115   114   163   147   
     66    91    87    80    126   115   114   163   148   
     66    91    87    80    126   115   114   163   148   
     66    91    87    80    126   115   114   163   147   

C2   69    96    91    101   173   147   165   271   214   
     69    96    91    101   174   147   165   271   214   
     70    97    92    102   175   149   166   272   215   
     70    98    92    102   175   149   167   273   216   

bg   66    92    88    80    126   116   114   164   148   
     66    92    88    80    127   116   115   165   149   
     67    93    89    81    127   117   115   165   150   
     66    92    88    80    127   116   115   164   149   

C3   68    95    91    84    150   148   123   214   222   
     68    95    91    84    149   148   123   214   221   
     68    95    91    84    149   148   123   214   221   
     68    95    91    84    149   148   123   214   221   

bg   66    92    88    80    126   116   115   164   149   
     66    92    88    80    126   116   114   164   148   
     66    92    88    80    126   116   114   164   148   
     66    92    88    80    126   116   114   164   148   
