     A1    A2    A3    B1    B2    B3    C1    C2    C3    

A1   135   151   101   105   149   122   118   166   150   
     135   151   101   106   149   122   118   166   150   
     135   151   101   106   149   122   118   166   150   
     135   151   101   105   149   122   118   166   150   

bg   67    94    90    81    129   118   117   167   151   
     66    92    88    80    126   116   115   164   148   
     66    92    88    80    126   116   114   164   148   
     66    92    88    80    126   116   115   164   149   

A2   109   203   157   98    170   144   118   169   152   
     109   203   157   98    170   144   118   169   152   
     109   203   157   98    170   144   118   169   152   
     109   203   156   98    170   144   118   169   152   

bg   66    92    88    80    127   116   115   164   149   
     66    92    88    80    126   116   114   164   148   
     66    92    88    80    126   116   114   164   148   
     66    92    88    80    126   116   114   164   148   

A3   73    145   168   83    150   147   116   166   152   
     73    145   168   83    150   147   115   166   152   
     73    145   168   83    150   147   115   166   151   
     73    145   168   83    150   147   115   166   151   

bg   65    91    87    79    125   115   113   162   147   
     66    91    87    79    125   115   114   163   147   
     66    92    88    80    126   116   114   164   148   
     66    92    87    80    126   115   114   163   148   

B1   97    119   95    154   191   132   149   194   157   
     97    119   95    154   191   132   149   194   157   
     97    119   95    154   191   133   149   194   157   
     97    119   95    154   191   132   149   194   157   

bg   67    93    88    80    127   117   115   165   149   
     66    92    88    80    126   116   114   164   148   
     66    92    88    80    126   116   115   164   149   
     66    92    88    80    126   116   115   164   149   

B2   85    135   116   121   239   186   138   210   179   
     85    134   116   121   238   184   137   209   178   
     85    135   116   121   238   185   137   209   178   
     86    136   117   122   239   186   138   211   180   

bg   66    92    88    80    127   117   115   165   149   
     66    92    88    80    127   116   115   164   149   
     67    93    89    81    128   118   116   166   150   
     68    94    90    82    130   119   118   168   152   

B3   69    111   115   85    176   192   119   188   182   
     69    111   115   85    176   192   119   187   182   
     69    111   115   85    176   192   119   187   182   
     69    111   115   85    176   192   119   187   182   

bg   66    92    88    80    126   116   115   164   149   
     66    92    88    80    126   116   114   164   148   
     66    91    87    79    125   115   113   162   147   
     65    91    86    79    124   114   113   161   146   

C1   70    95    89    113   158   127   194   234   169   
     69    95    89    113   158   127   194   234   169   
     70    95    89    113   158   127   194   234   169   
     70    95    89    113   159   127   194   234   169   

bg   66    92    88    80    126   116   114   164   148   
     66    92    88    80    126   116   114   164   148   
     66    92    88    80    126   116   114   164   148   
     66    92    88    80    127   116   115   164   149   

C2   69    96    91    101   173   147   165   270   213   
     69    96    91    101   174   147   165   271   214   
     69    96    91    101   174   147   165   270   214   
     69    96    91    101   173   147   165   270   213   

bg   66    92    88    80    127   116   115   164   149   
     66    92    88    80    127   116   115   164   149   
     66    92    88    80    127   116   115   164   149   
     66    92    88    80    126   116   114   164   148   

C3   68    95    91    84    149   148   123   214   221   
     67    94    91    83    149   147   122   213   221   
     67    94    91    83    149   147   122   213   221   
     67    94    90    83    148   147   122   212   220   

bg   66    91    87    80    126   115   114   163   148   
     66    92    88    80    126   116   114   164   148   
     66    92    88    80    126   116   114   164   148   
     66    92    88    80    126   116   114   164   148   
