     A1    A2    A3    B1    B2    B3    C1    C2    C3    

A1   128   146   100   103   148   122   118   166   150   
     128   146   100   103   148   122   118   167   150   
     129   146   101   104   149   123   119   168   151   
     128   146   101   103   148   122   118   167   151   

bg   66    92    88    80    127   116   115   165   149   
     66    92    88    80    127   116   115   164   148   
     67    93    88    81    127   117   115   165   149   
     66    93    88    80    127   116   115   165   149   

A2   109   203   157   98    170   144   118   169   152   
     109   203   157   98    171   144   118   169   152   
     110   204   158   99    172   145   120   171   154   
     110   204   157   99    172   145   119   171   153   

bg   67    93    88    81    127   117   115   165   149   
     66    92    88    80    126   116   115   164   148   
     66    92    88    80    126   116   115   164   148   
     67    92    88    81    127   116   115   165   149   

A3   73    145   168   84    151   147   116   167   152   
     73    145   168   83    150   147   116   166   152   
     73    145   168   84    151   147   116   167   152   
     73    145   168   84    151   147   116   167   152   

bg   67    94    89    81    128   118   116   166   150   
     66    92    88    80    126   116   114   164   148   
     66    92    88    80    126   116   115   164   148   
     67    93    88    81    127   117   115   165   149   

B1   97    119   95    154   192   133   150   195   157   
     97    119   95    154   191   132   149   194   156   
     97    119   95    154   191   132   149   194   157   
     97    120   95    154   192   133   150   195   157   

bg   66    91    87    79    125   115   113   162   147   
     66    91    87    79    125   115   113   162   147   
     66    92    87    80    126   115   114   163   148   
     66    92    88    80    126   116   114   164   148   

B2   84    134   115   120   237   184   136   208   176   
     84    133   115   120   237   183   135   207   176   
     84    133   114   120   236   183   135   206   175   
     84    133   114   119   236   182   135   206   175   

bg   67    93    89    81    128   117   116   165   150   
     77    101   96    95    142   134   132   187   174   
     66    93    89    81    128   118   115   165   150   
     66    92    88    80    126   116   114   164   148   

B3   68    110   115   84    175   192   118   187   181   
     69    110   115   85    176   192   119   187   181   
     69    110   115   84    175   192   118   187   181   
     69    111   115   85    176   192   119   187   181   

bg   67    94    89    81    128   118   117   167   151   
     68    94    90    82    129   119   117   168   152   
     67    93    89    81    127   117   116   166   150   
     66    92    88    80    126   116   114   164   148   

C1   69    95    89    113   158   126   194   234   169   
     70    95    89    113   158   127   194   234   169   
     70    95    89    113   159   127   194   234   169   
     70    95    89    113   159   127   194   234   169   

bg   66    92    88    80    126   116   114   164   148   
     66    92    88    80    127   116   115   164   148   
     66    92    88    80    127   116   115   164   148   
     66    92    88    80    127   116   115   164   148   

C2   69    96    90    100   173   147   165   270   213   
     69    96    90    100   173   147   165   270   212   
     69    96    91    100   173   147   165   270   212   
     69    96    90    100   173   147   165   270   212   

bg   67    93    89    81    128   117   116   166   150   
     69    96    91    83    132   121   119   171   154   
     66    92    88    80    127   116   115   164   148   
     66    91    87    80    126   115   114   163   147   

C3   67    94    90    83    148   146   121   212   219   
     67    94    90    83    148   147   122   212   219   
     67    94    90    83    149   147   122   213   220   
     68    95    91    84    150   148   123   214   221   

bg   66    91    87    79    126   115   114   163   147   
     66    92    88    80    126   116   114   164   148   
     66    92    87    80    126   115   114   163   147   
     66    91    87    80    126   115   114   163   147   
