Trial #1-------------------------

     A1    A2    A3    B1    B2    B3    C1    C2    C3    

A1   139   157   106   104   143   120   107   155   146   
     139   157   106   104   143   120   107   156   146   
     138   157   106   104   143   121   108   156   146   
     138   157   106   104   144   121   108   156   147   

bg   63    86    88    73    113   112   103   153   145   
     63    86    88    73    113   112   103   153   145   
     63    86    88    73    113   112   103   153   145   
     63    86    88    73    113   112   103   153   145   

A2   109   198   156   93    160   141   107   157   148   
     109   198   156   93    161   141   107   157   148   
     109   198   156   93    161   141   107   158   148   
     109   198   156   93    161   141   107   158   149   

bg   64    87    88    74    114   113   104   154   146   
     64    87    89    74    115   114   105   155   147   
     64    87    89    75    115   114   105   155   147   
     65    88    89    75    116   115   105   157   148   

A3   76    145   178   84    147   154   114   171   163   
     75    143   179   82    145   150   110   167   160   
     71    139   172   78    138   145   106   158   151   
     71    138   172   77    137   144   106   157   150   

bg   64    87    89    74    115   114   105   155   147   
     64    87    89    75    115   114   105   155   147   
     64    87    88    74    114   113   105   154   146   
     64    86    88    74    114   113   104   154   145   

B1   94    115   96    148   181   130   137   184   154   
     94    115   96    148   181   130   137   184   155   
     94    115   96    148   181   130   137   184   154   
     94    115   96    148   180   130   137   184   154   

bg   64    87    88    74    114   113   105   154   146   
     64    87    88    74    114   113   105   155   146   
     64    87    88    74    114   113   105   155   146   
     64    87    89    74    115   113   105   155   146   

B2   84    133   118   117   231   185   124   197   175   
     84    133   118   117   231   185   124   197   175   
     84    133   118   117   231   185   124   196   175   
     84    133   118   117   231   184   124   196   175   

bg   64    87    89    74    115   113   105   155   146   
     64    87    89    74    114   113   105   155   146   
     64    87    89    74    115   113   105   155   146   
     64    87    89    74    115   113   105   155   146   

B3   68    110   121   81    171   200   109   181   186   
     68    110   122   81    171   199   109   181   186   
     68    110   122   81    171   199   109   181   186   
     68    110   122   81    171   200   109   181   186   

bg   64    87    89    74    115   114   105   155   146   
     64    87    89    74    115   114   105   155   146   
     64    87    89    74    115   114   105   155   147   
     64    87    89    74    115   113   105   155   146   

C1   68    90    90    107   144   124   185   230   166   
     68    90    90    107   145   124   185   230   166   
     68    91    90    107   145   124   185   230   166   
     68    91    91    107   145   124   185   230   167   

bg   64    87    89    74    115   114   105   155   147   
     64    87    89    74    115   114   105   155   147   
     64    87    89    74    115   114   105   155   146   
     64    87    88    74    114   113   104   154   146   

C2   66    91    91    93    158   144   154   276   217   
     66    91    91    93    158   144   154   276   217   
     66    91    91    93    158   145   154   276   217   
     66    91    91    93    159   145   155   276   217   

bg   64    87    89    74    115   114   105   155   147   
     64    87    89    74    115   114   105   155   147   
     64    87    89    74    115   114   105   155   146   
     64    87    89    74    115   114   105   155   146   

C3   66    90    92    77    136   148   111   208   231   
     66    90    92    77    136   148   111   208   231   
     66    90    92    77    136   148   111   208   231   
     66    90    92    77    136   148   111   208   231   

bg   64    87    89    74    115   114   105   155   146   
     64    87    89    74    115   114   105   155   147   
     64    87    89    74    115   114   105   155   146   
     64    87    89    74    115   114   105   155   147   


Trial #2-------------------------

     A1    A2    A3    B1    B2    B3    C1    C2    C3    

A1   139   158   107   105   145   122   109   158   148   
     139   157   107   105   145   122   109   158   148   
     139   157   107   105   145   122   109   158   148   
     139   157   107   105   145   122   109   158   149   

bg   64    87    89    74    115   114   105   155   147   
     64    87    89    75    115   114   105   156   147   
     64    87    89    74    115   114   105   155   147   
     64    87    89    74    115   114   105   155   147   

A2   110   199   157   94    162   143   108   159   150   
     110   199   157   94    161   142   107   159   150   
     110   199   157   93    161   142   107   159   149   
     110   199   157   93    161   142   107   158   149   

bg   64    87    88    74    114   113   104   154   146   
     64    87    88    74    114   113   104   154   146   
     64    87    89    74    115   114   105   155   147   
     65    88    89    75    116   115   106   157   148   

A3   72    140   174   79    140   147   109   161   154   
     72    140   174   79    140   147   108   161   154   
     72    140   174   79    140   146   108   160   153   
     71    139   173   78    138   145   107   159   151   

bg   64    87    89    74    114   114   104   155   146   
     64    87    88    74    114   113   104   154   146   
     64    87    88    74    114   113   104   154   146   
     64    87    88    74    114   113   104   155   146   

B1   94    116   96    148   181   131   138   185   155   
     94    116   96    148   181   131   138   185   155   
     94    116   96    148   181   131   138   185   155   
     94    116   96    148   181   130   137   184   155   

bg   64    87    88    74    114   113   104   154   146   
     64    86    88    74    114   113   104   154   146   
     64    86    88    74    114   113   104   154   146   
     64    86    88    74    114   113   104   154   146   

B2   84    133   118   117   230   184   123   196   175   
     84    133   118   117   230   184   123   196   175   
     84    133   118   117   230   184   123   195   174   
     84    132   117   116   229   183   123   195   174   

bg   64    86    88    74    114   113   104   153   145   
     64    86    88    74    114   113   104   154   145   
     64    87    88    74    114   113   104   154   146   
     64    87    89    74    114   113   104   155   146   

B3   68    110   121   81    170   199   109   180   185   
     68    110   121   80    170   199   109   180   185   
     68    110   121   81    170   199   109   180   185   
     68    110   121   81    170   199   109   180   185   

bg   64    87    88    74    114   113   104   154   146   
     64    87    88    74    114   113   104   154   146   
     64    87    88    74    114   113   104   154   146   
     64    87    88    74    114   113   104   154   146   

C1   68    90    90    107   144   123   185   230   166   
     68    90    90    107   144   124   185   230   166   
     68    90    90    107   144   124   185   230   166   
     68    90    90    107   144   124   185   230   166   

bg   64    87    89    74    115   114   105   155   147   
     64    87    89    75    115   114   105   155   147   
     64    87    89    74    115   114   105   155   147   
     64    87    89    75    115   114   105   156   147   

C2   67    91    92    94    159   145   155   278   218   
     67    91    92    94    159   145   155   278   218   
     67    91    92    94    159   146   155   278   219   
     67    92    92    94    160   146   156   278   219   

bg   65    87    89    75    115   115   105   155   147   
     64    87    88    74    114   113   104   154   146   
     64    87    88    74    114   113   104   154   146   
     64    87    88    74    114   113   104   154   146   

C3   65    89    92    77    136   147   110   206   230   
     65    89    91    77    135   147   110   206   229   
     65    89    92    77    136   147   110   206   229   
     65    89    92    77    136   147   110   207   230   

bg   64    87    88    74    114   113   104   154   146   
     64    87    88    74    114   113   104   154   146   
     64    87    88    74    114   113   104   154   146   
     64    87    88    74    114   113   104   154   146   


Trial #3-------------------------

     A1    A2    A3    B1    B2    B3    C1    C2    C3    

A1   139   157   107   105   145   122   109   158   148   
     139   157   107   105   144   122   108   157   148   
     139   157   107   105   144   121   108   157   147   
     138   156   106   104   144   121   108   157   147   

bg   64    87    88    74    114   113   104   154   145   
     64    87    88    74    114   113   104   154   146   
     64    87    88    74    114   113   104   154   146   
     64    87    88    74    114   113   104   154   146   

A2   110   199   157   94    162   142   107   159   150   
     110   199   157   94    162   142   107   159   150   
     110   199   157   94    162   142   107   159   150   
     110   199   157   94    162   142   108   159   150   

bg   64    87    88    74    114   113   104   154   146   
     64    87    88    74    114   113   104   155   146   
     64    87    89    74    115   114   105   155   146   
     64    87    89    74    115   113   105   155   146   

A3   71    138   172   77    137   144   106   157   150   
     71    138   172   77    137   144   106   157   150   
     71    137   172   77    137   144   106   157   150   
     71    137   172   77    137   144   106   157   150   

bg   64    87    88    74    114   113   104   154   146   
     64    87    88    74    114   113   104   154   146   
     64    87    88    74    114   113   104   154   146   
     64    87    88    74    114   113   104   154   146   

B1   94    115   96    148   180   130   137   184   155   
     93    115   96    147   180   130   137   184   155   
     94    115   96    147   180   130   137   184   155   
     93    115   96    147   180   130   137   184   155   

bg   64    87    88    74    114   113   104   154   146   
     64    87    88    74    114   113   104   154   146   
     64    87    88    74    114   113   104   154   145   
     64    86    88    74    114   113   104   154   145   

B2   84    133   117   117   229   183   123   195   174   
     84    133   118   117   229   183   123   195   174   
     84    133   118   117   229   183   123   196   174   
     84    133   118   117   229   183   123   196   174   

bg   64    86    88    74    114   113   104   154   145   
     64    86    88    74    114   113   104   154   146   
     64    87    88    74    114   113   104   154   146   
     64    87    88    74    114   113   104   154   146   

B3   68    110   121   80    170   199   109   180   185   
     68    110   121   80    170   198   109   180   185   
     68    110   121   80    170   198   109   180   185   
     68    110   121   80    170   198   109   180   185   

bg   64    87    88    74    114   113   104   154   146   
     64    87    88    74    114   113   104   154   146   
     64    87    89    74    115   114   105   155   146   
     64    87    89    74    115   114   105   155   146   

C1   68    90    90    107   144   124   185   230   166   
     68    90    90    107   144   124   185   230   166   
     68    91    90    107   144   124   185   230   166   
     68    91    91    107   145   124   185   231   167   

bg   64    87    89    74    115   114   105   155   147   
     64    87    89    74    115   114   105   155   147   
     64    87    89    74    115   114   105   155   146   
     64    87    89    74    115   114   105   155   146   

C2   66    91    92    93    158   145   154   276   217   
     67    91    92    93    158   145   154   276   217   
     67    91    92    93    158   145   154   276   217   
     67    91    92    93    159   145   155   276   218   

bg   65    88    89    75    115   114   105   156   147   
     64    87    89    75    115   114   105   156   147   
     64    87    89    75    115   114   105   155   147   
     64    87    89    74    115   114   105   155   147   

C3   66    90    92    77    136   148   111   208   231   
     66    90    92    77    136   148   111   208   230   
     66    90    92    77    136   148   111   207   231   
     66    90    92    77    137   148   111   208   231   

bg   64    87    89    75    115   114   105   156   147   
     65    88    89    75    115   114   105   156   147   
     65    88    89    75    116   115   106   156   148   
     65    88    90    75    117   116   106   157   149   


Trial #4-------------------------

     A1    A2    A3    B1    B2    B3    C1    C2    C3    

A1   141   159   109   107   147   124   111   162   151   
     140   158   108   106   146   123   110   160   150   
     139   158   107   105   145   123   110   159   149   
     139   157   107   105   145   122   109   158   149   

bg   64    87    89    74    115   114   105   155   146   
     64    87    89    74    115   114   105   155   147   
     64    87    89    74    115   114   105   155   147   
     64    87    89    74    115   114   105   155   147   

A2   110   199   158   94    162   143   108   160   150   
     110   199   158   94    162   143   108   160   150   
     110   199   158   94    162   143   108   160   150   
     110   199   158   94    162   143   108   160   150   

bg   64    87    89    75    115   114   105   155   147   
     64    87    89    75    115   114   105   155   147   
     64    87    89    74    115   114   105   155   147   
     64    87    89    74    115   114   105   155   147   

A3   71    138   172   78    138   145   106   158   151   
     71    138   172   78    138   145   106   158   151   
     71    138   172   78    138   145   106   158   151   
     71    138   172   78    138   144   106   158   151   

bg   64    87    89    74    115   113   105   155   146   
     64    87    89    74    114   113   105   155   146   
     64    87    89    74    114   113   105   155   146   
     64    87    89    74    114   113   104   155   146   

B1   94    115   96    148   181   131   137   185   155   
     94    115   97    147   180   131   137   185   155   
     94    115   96    147   180   130   137   184   155   
     93    115   96    147   180   130   137   184   155   

bg   64    86    88    74    114   113   104   154   145   
     64    86    88    74    114   113   104   153   145   
     64    86    88    74    114   113   104   153   145   
     64    86    88    74    114   113   104   154   145   

B2   84    133   118   117   229   183   123   195   174   
     84    133   118   117   229   183   123   195   174   
     84    133   118   117   229   183   123   195   174   
     84    133   118   117   229   183   123   195   174   

bg   64    86    88    74    114   113   104   154   146   
     64    86    88    74    114   113   104   154   146   
     64    86    88    74    114   113   104   154   145   
     64    86    88    74    114   113   104   154   145   

B3   67    109   121   80    169   198   108   179   184   
     67    109   121   80    169   198   108   179   184   
     68    109   121   80    170   198   108   179   184   
     68    110   121   80    170   198   109   180   185   

bg   64    86    88    74    114   113   104   154   145   
     64    86    88    74    114   113   104   154   146   
     64    87    88    74    114   113   104   154   146   
     64    87    88    74    114   113   104   154   146   

C1   68    90    90    106   144   124   184   229   166   
     68    90    90    106   144   124   184   229   166   
     68    90    90    107   144   124   184   230   166   
     68    90    90    107   144   124   184   229   166   

bg   64    87    88    74    114   113   104   154   146   
     64    87    88    74    114   113   104   154   146   
     64    87    89    74    115   114   105   155   147   
     64    87    89    74    115   114   105   155   147   

C2   67    91    92    94    159   146   155   278   219   
     67    91    92    94    159   145   155   276   218   
     66    91    91    93    158   144   154   275   216   
     66    90    91    93    158   144   154   275   216   

bg   63    86    88    74    113   112   104   153   145   
     64    86    88    74    114   113   104   153   145   
     64    86    88    74    114   113   104   154   145   
     64    86    88    74    114   113   104   154   145   

C3   65    89    91    77    135   147   110   206   230   
     65    89    91    77    135   147   110   206   230   
     65    89    91    77    135   147   110   206   229   
     65    89    91    77    135   147   110   206   229   

bg   64    86    88    74    114   113   104   153   145   
     64    86    88    74    114   113   104   154   145   
     64    86    88    74    114   113   104   154   145   
     64    86    88    74    114   113   104   154   145   


