Trial #1-------------------------

     A1    A2    A3    B1    B2    B3    C1    C2    C3    

A1   136   153   103   102   139   117   104   151   142   
     136   153   103   101   139   117   104   151   142   
     136   153   103   102   139   117   105   151   142   
     135   153   103   102   140   117   105   152   142   

bg   62    84    85    72    111   110   101   150   141   
     62    84    85    72    111   110   102   150   142   
     62    84    86    72    111   110   102   150   142   
     62    84    86    72    111   110   102   150   142   

A2   107   195   154   91    157   139   104   154   145   
     107   195   154   91    157   139   104   154   145   
     107   195   154   91    157   139   104   154   145   
     107   195   154   91    157   139   104   154   145   

bg   62    84    85    72    111   110   101   150   141   
     62    84    85    72    110   109   101   149   141   
     62    84    85    72    111   109   101   149   141   
     62    84    85    72    111   110   101   150   141   

A3   69    135   169   76    134   141   104   154   147   
     69    135   169   76    134   141   104   154   147   
     69    135   169   76    135   142   104   154   147   
     69    135   169   76    134   141   104   154   147   

bg   62    84    85    72    111   110   101   150   142   
     62    84    85    72    111   110   101   149   141   
     62    84    85    72    110   110   101   149   141   
     62    84    85    72    111   110   101   150   141   

B1   91    112   93    145   176   126   134   179   150   
     91    112   93    145   176   126   134   179   150   
     91    112   93    145   176   126   134   179   150   
     91    112   93    145   176   126   134   179   150   

bg   61    83    85    71    110   109   101   149   141   
     61    83    85    71    110   109   101   149   141   
     61    83    85    71    110   109   101   149   141   
     61    83    85    71    110   109   101   149   141   

B2   82    130   115   115   226   180   121   192   170   
     82    130   115   115   226   180   121   192   170   
     82    130   115   115   226   180   121   192   170   
     82    130   115   115   226   180   121   192   170   

bg   63    85    87    73    112   111   103   152   143   
     63    85    86    73    112   111   102   152   143   
     62    85    86    72    112   111   102   151   143   
     62    84    86    72    111   111   102   151   143   

B3   66    108   120   79    168   197   107   178   183   
     67    108   120   79    168   197   108   178   183   
     67    108   120   80    169   197   108   179   183   
     67    108   120   80    168   196   108   178   183   

bg   63    85    86    73    112   111   103   152   143   
     62    85    86    73    112   110   102   151   142   
     62    84    85    72    111   110   102   150   141   
     62    84    85    72    111   110   101   150   141   

C1   65    87    87    104   140   120   181   224   161   
     65    87    87    104   140   120   181   224   161   
     65    87    87    104   140   120   180   224   161   
     65    87    87    104   140   120   180   224   161   

bg   61    83    85    71    110   109   101   149   140   
     62    83    85    71    110   109   101   149   140   
     62    84    85    72    110   109   101   149   141   
     62    84    85    72    111   109   101   150   141   

C2   64    88    88    91    154   141   151   271   212   
     64    88    88    91    155   141   151   271   212   
     64    88    88    91    155   141   151   271   212   
     64    88    88    91    154   141   151   270   212   

bg   62    84    85    72    110   110   101   150   141   
     62    84    85    72    110   110   101   149   141   
     62    84    85    72    110   109   101   149   141   
     62    84    85    72    110   109   101   149   141   

C3   63    86    88    75    132   143   107   202   224   
     63    86    88    75    132   143   107   202   225   
     63    86    88    75    132   143   107   202   225   
     63    86    89    75    132   144   107   202   225   

bg   61    83    85    71    110   109   101   149   141   
     61    83    85    71    110   109   101   149   141   
     61    83    85    71    110   109   101   149   141   
     61    83    85    71    110   109   101   149   140   


Trial #2-------------------------

     A1    A2    A3    B1    B2    B3    C1    C2    C3    

A1   136   153   103   102   139   117   105   152   142   
     136   153   103   102   140   118   105   152   142   
     136   153   103   102   140   118   105   152   142   
     136   153   103   102   140   118   106   153   143   

bg   62    84    85    72    110   109   101   149   141   
     61    83    85    71    110   109   101   149   140   
     61    83    85    71    110   109   100   149   140   
     61    83    85    71    110   109   100   149   140   

A2   107   194   153   90    156   138   103   153   144   
     107   194   153   91    157   138   104   153   144   
     107   194   153   91    157   138   104   153   144   
     107   194   153   91    157   138   104   154   144   

bg   62    83    85    72    110   109   101   149   141   
     62    83    85    72    110   109   101   149   141   
     62    84    85    72    110   109   101   149   141   
     62    84    85    72    111   110   101   150   141   

A3   69    135   169   75    134   141   103   153   146   
     69    135   169   75    134   141   103   153   146   
     69    135   169   75    134   141   103   153   146   
     69    135   169   76    134   141   103   154   147   

bg   62    84    86    72    111   110   102   151   142   
     62    84    86    72    111   110   102   150   142   
     62    84    85    72    111   110   102   150   141   
     62    84    85    72    111   110   102   150   141   

B1   92    113   94    145   177   127   135   180   151   
     92    113   94    145   177   128   135   181   152   
     92    113   94    145   178   128   135   181   152   
     92    113   94    145   177   128   135   181   152   

bg   62    84    85    72    111   110   101   150   141   
     62    84    85    72    111   110   101   150   141   
     62    84    85    72    111   110   101   150   141   
     62    84    85    72    111   110   102   150   141   

B2   82    129   114   114   225   179   120   191   169   
     82    129   114   114   225   179   120   191   169   
     82    129   114   114   225   179   120   191   170   
     82    129   114   114   225   179   120   190   169   

bg   61    84    85    71    110   109   101   149   141   
     61    83    85    71    110   109   101   149   141   
     61    83    85    71    110   109   101   149   141   
     61    83    85    71    110   109   101   149   141   

B3   65    106   117   78    165   194   105   174   179   
     65    106   117   78    165   193   105   174   179   
     65    106   117   78    166   194   105   174   179   
     65    106   118   78    166   194   105   174   179   

bg   62    84    85    72    111   110   101   150   141   
     62    84    85    72    111   110   101   150   141   
     62    84    85    72    111   110   101   150   142   
     62    84    85    72    111   110   101   150   141   

C1   65    87    87    104   140   120   181   225   161   
     65    87    87    104   140   120   181   224   161   
     65    87    87    104   140   120   181   225   161   
     65    87    87    104   140   120   181   224   161   

bg   62    84    85    72    111   110   102   150   141   
     62    84    86    72    111   110   102   150   142   
     62    84    86    72    111   110   102   151   142   
     62    85    86    72    111   110   102   151   142   

C2   65    89    89    92    156   142   152   272   214   
     65    89    90    92    156   143   152   273   214   
     65    89    90    92    156   143   153   273   215   
     65    89    90    92    157   143   153   273   215   

bg   62    84    86    72    111   110   102   150   142   
     62    84    86    72    111   110   102   150   142   
     62    84    86    72    111   110   102   150   142   
     62    84    86    72    111   110   102   150   142   

C3   63    87    89    75    132   144   107   202   225   
     63    86    89    75    132   144   107   202   225   
     63    86    89    75    132   144   107   202   225   
     63    86    89    75    132   144   107   202   225   

bg   62    84    85    72    111   110   101   150   141   
     62    84    85    72    111   110   101   150   141   
     62    84    85    72    110   109   101   149   141   
     62    84    85    72    110   109   101   149   141   


Trial #3-------------------------

     A1    A2    A3    B1    B2    B3    C1    C2    C3    

A1   136   153   103   102   140   117   105   152   142   
     136   153   103   102   140   118   105   152   143   
     135   153   103   102   140   117   105   152   142   
     135   153   103   101   139   118   105   152   142   

bg   62    84    86    72    111   111   102   151   143   
     62    83    85    72    110   109   101   149   141   
     61    83    85    71    110   109   100   149   140   
     61    83    85    71    110   109   101   149   140   

A2   107   194   153   91    157   138   104   154   144   
     107   194   153   91    157   138   104   154   144   
     107   194   153   91    157   138   104   154   144   
     107   194   153   91    157   138   104   153   144   

bg   61    83    85    71    110   109   101   149   140   
     61    83    85    71    110   109   100   149   140   
     61    83    85    71    110   109   100   148   140   
     61    83    85    71    110   109   100   149   141   

A3   68    133   167   74    132   139   102   151   144   
     68    133   167   74    132   139   102   151   144   
     68    133   167   74    132   139   102   151   144   
     68    133   166   74    132   139   102   151   144   

bg   61    83    85    71    110   109   101   149   140   
     61    83    85    71    110   109   101   149   140   
     61    83    85    71    110   109   101   149   140   
     61    83    85    71    110   109   101   149   140   

B1   91    112   93    144   176   126   133   178   149   
     91    112   93    144   176   126   133   178   149   
     91    112   93    144   176   126   133   179   149   
     91    112   93    144   176   126   134   179   150   

bg   62    84    85    72    110   109   101   149   141   
     62    83    85    72    110   109   101   149   140   
     62    83    85    72    110   109   101   149   140   
     62    83    85    72    110   109   101   149   141   

B2   81    129   114   114   225   179   120   190   169   
     81    129   114   114   225   179   119   190   169   
     81    129   114   114   224   179   120   190   169   
     81    129   114   114   224   179   120   190   169   

bg   61    83    85    71    110   109   101   149   140   
     61    83    85    71    110   109   101   149   140   
     61    83    85    71    110   109   101   149   140   
     62    83    85    71    110   109   101   149   140   

B3   65    106   118   78    166   194   105   175   179   
     65    106   118   78    166   194   105   175   179   
     65    106   118   78    166   194   105   175   180   
     65    106   118   78    166   194   105   175   180   

bg   62    84    85    71    110   110   101   149   141   
     62    84    85    72    110   110   101   149   141   
     62    84    85    72    110   109   101   149   141   
     62    84    85    72    110   109   101   149   141   

C1   65    87    87    104   140   119   181   224   160   
     65    87    87    104   140   119   181   223   160   
     65    87    87    104   140   119   181   223   160   
     65    87    87    104   140   119   180   223   160   

bg   61    83    85    71    110   109   101   149   141   
     61    83    85    71    110   109   101   149   141   
     61    83    85    71    110   109   101   149   141   
     61    83    85    71    110   109   101   149   141   

C2   64    87    88    91    154   141   151   271   212   
     64    88    88    91    154   141   151   271   212   
     64    88    88    91    155   141   151   271   212   
     64    88    88    91    155   141   151   271   212   

bg   62    84    85    72    110   109   101   149   141   
     62    84    85    72    110   110   101   149   141   
     62    84    85    72    110   110   101   149   141   
     62    84    85    72    110   109   101   149   141   

C3   63    86    89    75    132   143   107   201   225   
     63    86    89    75    132   143   107   202   225   
     63    86    89    75    132   143   107   202   225   
     63    86    89    75    132   143   107   202   224   

bg   62    83    85    72    110   109   101   149   140   
     61    83    85    72    110   109   101   149   140   
     61    83    85    71    110   109   101   149   140   
     61    83    85    71    110   109   101   149   140   


Trial #4-------------------------

     A1    A2    A3    B1    B2    B3    C1    C2    C3    

A1   136   154   103   102   140   118   105   153   143   
     136   153   103   102   140   118   105   152   143   
     135   153   103   102   140   118   105   152   143   
     135   153   103   102   140   118   105   153   143   

bg   62    84    85    72    110   109   101   149   141   
     62    84    85    72    110   109   101   149   141   
     62    84    85    72    111   110   101   150   141   
     62    84    85    72    111   110   101   150   141   

A2   107   195   153   91    157   138   104   154   145   
     107   195   153   91    157   138   104   154   145   
     107   194   153   91    157   138   104   154   145   
     107   195   153   91    157   138   104   154   145   

bg   62    84    85    71    110   109   101   149   141   
     62    84    85    71    110   109   101   149   141   
     62    83    85    71    110   109   101   149   141   
     62    83    85    72    110   109   101   149   141   

A3   68    134   167   75    133   140   102   152   145   
     68    134   167   75    133   140   102   152   144   
     68    134   167   75    133   139   102   152   144   
     68    134   167   75    133   140   102   152   145   

bg   61    83    85    71    110   109   101   149   140   
     61    83    85    71    110   109   100   149   140   
     61    83    85    71    110   109   100   149   141   
     62    84    85    72    111   110   101   150   141   

B1   91    112   93    145   176   126   134   179   149   
     91    112   93    145   176   126   134   179   150   
     92    112   93    145   176   126   134   179   150   
     91    112   93    145   176   126   134   179   149   

bg   61    83    85    71    110   109   101   149   140   
     62    83    85    71    110   109   101   149   141   
     62    83    85    71    110   109   101   149   141   
     61    83    85    71    110   109   101   149   141   

B2   81    129   114   114   225   179   119   190   169   
     81    129   114   114   224   179   119   190   169   
     81    129   114   114   224   179   119   189   169   
     81    129   114   114   224   179   119   190   169   

bg   62    83    85    72    110   109   101   149   141   
     62    84    85    72    110   109   101   149   141   
     62    84    85    72    110   109   101   149   141   
     62    84    85    72    110   109   101   149   141   

B3   65    106   118   78    166   195   105   174   180   
     65    106   118   78    166   194   105   174   180   
     65    106   118   78    166   194   105   174   180   
     65    106   118   78    166   194   105   174   179   

bg   62    84    85    72    110   109   101   149   141   
     62    84    85    72    110   109   101   149   141   
     62    84    85    72    110   109   101   149   141   
     62    84    85    72    110   109   101   149   141   

C1   65    87    87    104   140   119   181   224   160   
     65    87    87    104   140   119   180   224   160   
     65    87    87    104   140   120   180   224   160   
     65    87    87    103   139   119   180   223   160   

bg   61    83    85    71    110   109   100   149   140   
     62    84    85    72    111   110   101   149   141   
     62    84    85    72    111   110   102   150   142   
     62    84    86    72    112   111   102   151   143   

C2   67    91    91    96    162   148   159   285   225   
     72    100   101   102   170   157   167   295   234   
     71    93    93    96    158   144   159   280   220   
     64    88    89    92    155   141   152   271   212   

bg   61    83    85    71    110   109   101   149   141   
     61    83    85    71    110   109   101   149   141   
     61    83    85    71    110   109   101   149   141   
     61    83    85    71    110   109   101   149   141   

C3   63    86    88    75    132   143   107   202   225   
     63    86    89    75    132   144   107   202   225   
     63    86    88    75    132   143   107   201   224   
     63    86    88    75    132   143   107   201   224   

bg   61    83    85    71    110   109   101   149   140   
     61    83    85    71    110   109   101   149   140   
     61    83    85    71    110   109   101   149   140   
     61    83    85    71    110   109   100   148   140   


