Trial #1-------------------------

     A1    A2    A3    B1    B2    B3    C1    C2    C3    

A1   100   104   51    59    75    51    44    63    57    
     99    103   51    59    74    51    44    63    57    
     99    103   52    59    74    51    44    63    57    
     98    103   52    59    74    51    43    62    57    

bg   24    33    33    28    44    43    39    59    55    
     24    33    33    28    44    43    39    59    55    
     24    33    33    28    44    43    39    59    55    
     24    33    33    28    44    43    39    59    55    

A2   70    144   101   48    91    71    42    63    59    
     70    144   101   48    91    71    42    63    59    
     70    144   101   48    91    71    42    63    59    
     70    144   101   48    91    71    42    63    59    

bg   24    33    33    28    44    42    39    59    55    
     24    33    33    28    44    42    39    58    55    
     24    33    33    28    43    42    39    58    55    
     24    33    33    28    43    42    39    58    55    

A3   31    84    117   31    67    74    40    61    59    
     31    84    116   31    67    73    40    61    59    
     31    84    116   31    67    73    41    61    59    
     31    84    115   31    67    73    41    61    59    

bg   24    33    33    28    44    42    39    59    55    
     24    33    33    28    44    42    39    59    55    
     24    33    33    28    43    42    39    58    55    
     24    33    33    28    43    42    39    58    55    

B1   53    62    41    101   110   60    71    88    64    
     53    62    41    101   110   60    71    89    64    
     53    62    41    101   110   60    71    89    64    
     53    62    41    101   110   60    71    89    64    

bg   24    33    33    28    44    42    39    59    55    
     24    33    33    28    44    42    39    59    55    
     24    33    33    28    44    42    39    59    55    
     24    33    33    28    44    42    39    59    55    

B2   44    79    63    71    159   113   58    100   84    
     44    80    63    71    159   113   58    100   84    
     44    80    63    71    159   113   58    100   84    
     44    79    63    71    159   113   58    100   84    

bg   24    33    33    28    44    43    40    59    56    
     24    33    33    28    44    43    40    60    56    
     24    33    33    28    44    43    40    59    56    
     24    33    33    28    44    43    40    59    55    

B3   28    56    66    35    100   127   44    84    94    
     28    56    66    35    100   127   44    84    94    
     28    56    66    35    100   127   44    84    94    
     28    56    66    35    100   128   44    85    94    

bg   24    33    33    28    44    43    39    59    56    
     24    33    33    28    44    43    39    59    56    
     24    33    33    28    44    43    39    59    56    
     24    33    33    28    44    43    39    59    56    

C1   28    37    35    61    74    53    120   135   76    
     28    37    35    61    74    53    120   135   76    
     28    37    35    61    75    53    120   135   75    
     28    37    35    61    74    53    120   135   75    

bg   24    33    33    28    44    43    39    59    55    
     24    33    33    28    44    43    39    59    55    
     24    33    33    28    44    43    39    59    55    
     24    33    33    28    44    43    39    59    55    

C2   26    37    36    48    88    74    89    180   126   
     26    37    36    48    88    74    89    180   126   
     26    37    36    48    88    74    89    180   126   
     26    37    36    48    88    74    89    180   126   

bg   24    33    33    28    44    42    39    59    55    
     24    33    33    28    44    42    39    59    55    
     24    33    33    28    44    43    39    59    55    
     24    33    33    28    44    43    39    59    55    

C3   25    36    37    31    66    77    45    112   141   
     25    36    37    31    66    77    45    112   141   
     25    36    37    31    66    77    45    112   140   
     25    36    37    31    66    77    45    112   140   

bg   24    33    33    28    44    42    39    59    55    
     24    33    33    28    44    42    39    59    55    
     24    33    33    28    44    42    39    59    55    
     24    33    33    28    44    42    39    59    55    


Trial #2-------------------------

     A1    A2    A3    B1    B2    B3    C1    C2    C3    

A1   99    104   52    59    74    51    43    62    57    
     98    103   52    59    74    51    43    62    57    
     98    103   51    58    74    51    43    62    57    
     98    103   51    58    74    51    43    62    57    

bg   24    33    33    28    44    42    39    59    55    
     24    33    33    28    44    42    39    59    55    
     24    33    33    28    44    42    39    59    55    
     24    33    33    28    44    42    39    59    55    

A2   70    145   102   48    91    72    42    63    59    
     70    145   102   48    91    72    42    63    59    
     70    145   102   48    91    72    42    63    59    
     70    145   102   48    91    72    42    63    59    

bg   24    33    33    28    44    43    39    59    55    
     24    33    33    28    44    43    39    59    55    
     24    33    33    28    44    43    39    59    55    
     24    33    33    28    44    43    39    59    55    

A3   31    84    115   31    67    73    41    61    59    
     31    84    115   31    67    73    41    62    59    
     31    84    115   32    67    73    41    62    59    
     31    84    115   31    67    73    41    62    59    

bg   24    33    33    28    44    43    39    59    55    
     24    33    33    28    44    43    39    59    55    
     24    33    33    28    44    43    39    59    55    
     24    33    33    28    44    43    39    59    55    

B1   54    62    41    102   111   60    72    89    64    
     54    62    41    102   111   60    72    89    64    
     54    62    41    102   111   60    72    89    64    
     54    62    41    103   111   60    72    89    64    

bg   24    33    33    28    44    43    40    59    56    
     24    33    33    28    44    43    40    59    56    
     24    33    33    28    44    43    39    59    56    
     24    33    33    28    44    43    39    59    56    

B2   45    80    63    72    160   114   58    101   85    
     45    80    63    72    160   114   58    101   85    
     45    80    63    72    160   114   59    101   85    
     45    80    63    72    160   113   59    101   84    

bg   24    33    33    28    44    43    40    59    55    
     24    33    33    28    44    43    40    59    55    
     24    33    33    28    44    43    40    59    56    
     24    33    33    28    44    43    40    60    56    

B3   28    56    67    35    100   129   44    85    95    
     28    57    67    35    100   129   44    85    95    
     28    57    67    35    100   129   44    85    95    
     28    57    67    35    100   129   44    85    95    

bg   24    33    33    28    44    43    40    59    56    
     24    33    33    28    44    43    40    60    56    
     24    33    33    28    44    43    40    60    56    
     24    33    33    28    44    43    40    60    56    

C1   28    37    35    61    75    54    120   135   76    
     28    37    35    61    75    54    120   135   76    
     28    37    35    61    75    54    120   135   76    
     28    37    35    61    74    54    119   135   76    

bg   24    33    33    28    44    43    39    59    56    
     24    33    33    28    44    43    39    59    56    
     24    33    33    28    44    43    39    59    56    
     24    33    33    28    44    43    40    59    56    

C2   27    37    36    48    89    75    90    181   127   
     27    37    36    48    89    75    90    181   127   
     27    37    36    48    89    75    90    181   127   
     27    37    36    48    89    75    90    181   127   

bg   24    33    33    28    44    43    40    59    56    
     24    33    34    28    44    43    39    59    56    
     24    33    34    28    44    43    39    59    56    
     24    33    34    28    44    43    39    60    56    

C3   26    36    37    32    66    78    46    113   141   
     26    36    37    32    67    78    46    113   140   
     26    36    37    32    67    78    46    113   140   
     26    36    37    32    67    78    46    114   140   

bg   25    34    34    29    45    44    40    60    56    
     24    34    34    29    45    43    40    60    56    
     24    33    34    28    44    43    40    60    56    
     24    33    34    28    44    43    40    60    56    


Trial #3-------------------------

     A1    A2    A3    B1    B2    B3    C1    C2    C3    

A1   99    104   52    59    75    52    44    63    58    
     99    104   52    59    75    52    44    63    58    
     99    104   52    59    75    52    44    63    58    
     99    104   52    59    75    52    44    63    58    

bg   24    33    33    28    44    43    40    60    56    
     24    33    33    28    44    43    40    60    56    
     24    33    33    28    44    43    40    59    56    
     24    33    33    28    44    43    40    59    56    

A2   70    145   102   48    92    72    42    64    59    
     70    145   102   48    92    72    42    64    59    
     70    145   102   48    91    72    42    64    59    
     70    145   102   48    91    72    42    64    59    

bg   24    33    33    28    44    43    40    60    56    
     24    33    33    28    44    43    40    60    56    
     24    33    33    28    44    43    40    60    56    
     24    33    33    28    44    43    40    59    56    

A3   31    84    116   32    67    74    41    62    60    
     31    84    116   32    67    74    41    62    60    
     31    84    116   32    67    74    41    62    60    
     31    84    117   32    67    74    41    62    60    

bg   24    33    34    28    44    43    40    60    56    
     24    33    34    28    45    43    40    60    56    
     24    33    34    28    44    43    40    60    56    
     24    33    33    28    44    43    40    59    56    

B1   54    62    41    103   111   60    73    90    64    
     55    63    42    103   111   60    73    90    64    
     55    63    42    103   111   60    73    90    65    
     55    63    42    103   111   61    73    90    65    

bg   24    33    34    28    44    43    40    60    56    
     24    33    33    28    44    43    40    60    56    
     24    33    33    28    44    43    39    59    56    
     24    33    33    28    44    43    39    59    56    

B2   45    80    63    72    160   114   59    101   84    
     45    80    63    72    160   114   59    101   84    
     45    80    63    72    160   113   59    101   84    
     45    80    63    72    159   113   59    101   84    

bg   24    33    33    28    44    43    39    59    55    
     24    33    33    28    44    43    39    59    55    
     24    33    33    28    44    43    39    59    55    
     24    33    33    28    44    43    39    59    56    

B3   28    56    67    35    100   129   43    85    95    
     28    56    67    35    100   129   43    85    95    
     28    56    66    35    100   128   44    85    94    
     28    56    66    35    100   128   44    85    94    

bg   24    33    33    28    44    43    39    59    55    
     24    33    33    28    44    43    39    59    55    
     24    33    33    28    44    43    39    59    55    
     24    33    33    28    44    43    39    59    55    

C1   27    37    35    61    75    54    119   135   76    
     27    37    35    61    74    54    119   135   76    
     27    37    35    61    74    54    119   135   76    
     27    37    35    61    74    54    119   135   76    

bg   24    33    33    28    44    43    39    59    55    
     24    33    33    28    44    43    39    59    55    
     24    33    33    28    44    43    40    59    55    
     24    33    33    28    44    43    40    59    55    

C2   27    37    36    48    89    75    90    181   127   
     26    37    36    48    89    75    90    181   127   
     26    37    36    48    88    75    90    180   127   
     26    37    36    48    88    75    89    180   127   

bg   24    33    33    28    44    43    39    59    55    
     24    33    33    28    44    43    39    59    55    
     24    33    33    28    44    43    39    59    55    
     24    33    33    28    44    43    39    59    55    

C3   25    36    37    31    66    77    45    112   139   
     25    36    37    31    66    77    45    112   139   
     25    36    37    31    66    77    45    112   139   
     25    36    37    31    66    77    45    112   139   

bg   24    33    33    28    44    42    39    59    55    
     24    33    33    28    44    42    39    59    55    
     24    33    33    28    43    42    39    58    55    
     24    33    33    28    43    42    39    58    55    


Trial #4-------------------------

     A1    A2    A3    B1    B2    B3    C1    C2    C3    

A1   99    103   51    59    74    51    43    62    57    
     99    103   51    59    74    51    43    62    57    
     99    103   51    59    74    51    43    62    57    
     98    103   51    59    74    51    43    62    57    

bg   24    33    33    28    44    43    39    59    55    
     24    33    33    28    44    43    39    59    55    
     24    33    33    28    44    43    39    59    55    
     24    33    33    28    44    43    39    59    55    

A2   70    145   102   48    91    72    42    63    59    
     70    145   102   48    91    72    42    63    59    
     70    145   102   48    91    72    42    63    59    
     70    145   102   48    91    72    42    63    59    

bg   24    33    33    28    44    43    39    59    55    
     24    33    33    28    44    43    39    59    55    
     24    33    33    28    44    43    39    59    55    
     24    33    33    28    44    43    39    59    55    

A3   31    84    117   31    67    74    40    61    59    
     31    84    117   31    67    74    40    61    59    
     31    84    117   31    67    74    40    61    59    
     31    84    116   31    67    74    40    62    59    

bg   24    33    33    28    44    43    39    59    55    
     24    33    33    28    44    43    39    59    55    
     24    33    33    28    44    43    39    59    55    
     24    33    33    28    44    43    39    59    55    

B1   54    62    41    102   110   60    72    89    64    
     54    62    41    101   110   60    72    89    64    
     54    62    41    101   110   60    71    89    64    
     54    62    41    101   110   60    71    89    64    

bg   24    33    33    28    44    43    39    59    55    
     24    33    33    28    44    43    39    59    55    
     24    33    33    28    44    43    39    59    55    
     24    33    33    28    44    43    39    59    55    

B2   45    80    63    72    160   113   59    101   84    
     45    80    63    72    160   113   59    101   84    
     45    80    63    72    160   113   58    101   84    
     45    80    63    71    159   113   58    100   84    

bg   24    33    33    28    44    43    39    59    55    
     24    33    33    28    44    43    39    59    55    
     24    33    33    28    44    43    39    59    55    
     24    33    33    28    44    43    39    59    55    

B3   28    56    66    35    100   128   44    85    94    
     28    56    66    35    100   128   44    85    94    
     28    56    66    35    100   127   44    85    94    
     28    56    66    35    100   127   44    85    94    

bg   24    33    33    28    44    43    39    59    55    
     24    33    33    28    44    43    39    59    55    
     24    33    33    28    44    43    39    59    55    
     24    33    33    28    44    43    39    59    56    

C1   28    38    37    61    76    55    120   137   78    
     28    38    37    62    76    55    120   137   78    
     28    38    36    62    76    55    120   136   78    
     28    38    36    62    76    55    120   136   77    

bg   24    33    33    28    44    43    40    59    56    
     24    33    33    28    44    43    39    59    55    
     24    33    33    28    44    43    39    59    55    
     24    33    33    28    44    43    39    59    55    

C2   26    37    36    48    88    75    89    181   127   
     26    37    36    48    88    75    89    181   127   
     26    37    36    48    88    74    89    180   127   
     26    37    36    48    88    74    89    180   127   

bg   24    33    33    28    44    43    39    59    55    
     24    33    33    28    44    43    39    59    55    
     24    33    33    28    44    43    40    59    55    
     24    33    33    28    44    43    40    59    55    

C3   26    36    37    31    66    77    46    112   140   
     26    36    37    31    66    77    45    112   140   
     25    36    37    31    66    77    45    112   140   
     25    36    37    31    66    77    45    112   140   

bg   24    33    33    28    44    42    39    59    55    
     24    33    33    28    44    42    39    58    55    
     24    33    33    28    43    42    39    58    55    
     24    33    33    28    43    42    39    58    55    


