     A1    A2    A3    B1    B2    B3    C1    C2    C3    

A1   413   563   399   395   588   419   371   502   372   
     412   562   399   394   587   419   370   502   371   
     411   562   399   393   588   419   369   502   371   
     411   562   399   393   588   420   370   502   371   

bg   345   502   383   367   562   412   365   498   370   
     345   502   383   367   561   411   366   499   369   
     346   503   382   368   561   411   366   499   369   
     345   502   383   367   562   412   366   499   369   

A2   389   613   451   386   606   439   369   503   372   
     389   613   452   385   606   440   369   503   373   
     389   613   451   385   605   439   369   503   373   
     389   613   451   385   605   439   369   503   373   

bg   345   502   383   367   561   411   365   499   370   
     345   502   383   367   561   412   365   499   369   
     345   502   383   368   562   412   366   499   369   
     346   502   383   368   561   411   366   499   369   

A3   353   556   463   371   586   443   367   502   373   
     353   556   463   371   586   443   368   502   373   
     353   556   463   371   586   444   367   502   374   
     352   556   463   371   586   444   367   502   374   

bg   345   502   383   367   561   412   365   498   370   
     345   502   383   367   561   411   365   498   369   
     346   503   383   367   561   411   366   499   369   
     346   502   383   368   561   411   366   499   369   

B1   377   530   390   441   626   427   401   529   377   
     377   529   390   441   626   428   400   529   378   
     377   529   390   440   626   428   400   528   378   
     377   530   390   440   626   428   400   528   378   

bg   345   503   383   367   562   412   366   499   370   
     345   503   383   367   562   412   366   499   370   
     346   503   383   368   562   411   366   499   369   
     346   503   383   368   562   411   366   499   369   

B2   364   544   410   407   672   479   386   541   397   
     364   544   410   408   672   479   387   541   397   
     364   544   410   407   672   478   387   541   396   
     364   544   410   407   671   478   386   541   397   

bg   346   503   383   368   562   411   366   499   369   
     345   502   383   367   561   412   366   499   370   
     345   502   383   367   562   412   365   499   369   
     346   502   383   368   562   411   366   499   369   

B3   348   521   411   372   612   488   370   522   403   
     349   521   410   372   611   487   370   522   403   
     349   522   410   373   611   487   370   522   403   
     348   521   410   372   611   488   370   522   403   

bg   345   503   383   367   562   412   366   499   370   
     346   503   383   367   562   411   366   499   369   
     346   503   383   368   562   412   366   499   369   
     346   503   383   368   562   412   366   499   369   

C1   349   506   384   401   594   423   446   569   391   
     349   506   385   401   594   423   446   569   391   
     349   506   385   400   594   423   445   569   391   
     349   506   385   400   594   423   445   569   391   

bg   345   503   383   367   562   412   366   499   370   
     345   503   383   368   562   412   366   499   370   
     346   503   383   368   562   412   366   499   369   
     346   503   383   368   562   411   366   499   369   

C2   348   507   386   389   611   444   419   610   437   
     349   507   386   389   611   444   419   609   437   
     348   507   386   389   611   444   419   609   437   
     348   507   386   389   611   445   418   609   437   

bg   345   502   383   367   561   412   366   499   369   
     345   503   383   367   562   412   366   499   370   
     346   503   383   368   562   412   366   499   369   
     346   503   383   368   561   411   366   499   369   

C3   347   505   386   371   584   443   374   548   442   
     347   505   386   371   584   443   374   548   442   
     347   505   386   371   584   443   374   548   442   
     347   505   386   371   584   444   374   548   442   

bg   346   503   383   368   562   412   366   499   370   
     345   503   383   367   562   412   366   499   370   
     345   503   383   367   562   412   366   499   370   
     346   502   383   367   562   412   366   499   369   
