     A1    A2    A3    B1    B2    B3    C1    C2    C3    

A1   403   554   397   391   585   419   370   502   371   
     402   554   397   391   585   419   370   502   371   
     402   554   397   391   585   419   370   502   371   
     402   554   397   391   585   419   370   502   371   

bg   346   503   383   368   562   412   366   499   370   
     346   503   383   368   562   412   366   499   370   
     346   503   383   368   562   412   366   499   370   
     346   503   383   368   562   412   366   499   370   

A2   390   614   452   386   606   440   370   504   373   
     390   614   452   386   607   440   370   504   373   
     389   614   452   386   606   440   370   504   373   
     389   614   452   386   606   440   370   504   373   

bg   346   503   383   368   562   412   366   499   370   
     346   503   383   368   562   412   366   499   370   
     346   503   383   369   562   412   366   499   370   
     346   503   383   369   562   412   366   499   370   

A3   353   557   464   372   587   444   368   503   374   
     353   557   464   372   587   444   368   503   374   
     354   557   464   372   587   444   368   503   374   
     353   557   463   372   587   444   368   503   374   

bg   346   503   383   368   562   412   366   499   370   
     346   503   383   368   562   412   366   499   370   
     346   503   383   368   562   412   366   499   370   
     346   503   383   369   562   412   366   499   370   

B1   377   530   390   442   627   428   401   529   378   
     378   530   390   442   627   428   401   529   378   
     378   530   390   442   627   429   401   529   378   
     378   530   390   442   627   428   401   529   378   

bg   346   503   383   368   562   412   366   499   370   
     346   503   383   368   562   412   366   499   370   
     346   503   383   368   562   412   366   499   370   
     346   503   383   368   562   412   366   499   370   

B2   364   545   410   408   673   479   387   542   397   
     365   545   410   408   673   479   387   542   397   
     365   545   410   408   672   479   387   542   397   
     364   544   410   408   672   479   387   541   397   

bg   346   503   383   368   562   412   366   499   369   
     346   503   383   368   562   412   366   499   369   
     346   503   383   368   562   412   366   499   369   
     346   503   383   368   562   412   366   499   369   

B3   349   521   410   373   612   488   370   522   403   
     349   521   410   373   612   488   371   522   403   
     349   521   410   373   612   488   370   523   403   
     349   522   411   373   612   488   371   523   403   

bg   346   503   383   368   562   411   366   499   369   
     346   503   383   368   562   411   366   499   369   
     346   503   382   368   562   410   366   499   368   
     346   503   381   368   562   409   366   499   367   

C1   349   506   381   401   594   417   446   569   387   
     349   506   381   401   594   418   446   569   388   
     349   506   382   401   594   418   446   569   387   
     350   506   381   401   594   418   446   569   387   

bg   346   503   382   368   562   409   366   499   367   
     346   503   382   368   562   409   366   499   367   
     346   503   381   368   562   409   366   499   366   
     346   503   382   368   562   409   366   499   367   

C2   349   507   385   390   611   442   419   610   435   
     349   507   385   390   611   442   419   610   434   
     349   507   385   390   611   442   419   609   434   
     349   507   385   390   611   442   419   609   434   

bg   346   503   381   368   562   409   366   499   367   
     346   503   382   368   562   409   366   499   367   
     346   503   381   368   562   409   366   499   367   
     346   503   381   368   562   409   366   499   367   

C3   347   506   385   372   585   441   374   548   439   
     347   505   385   371   585   441   374   549   439   
     347   506   385   372   585   441   374   549   439   
     347   505   385   371   585   441   374   548   439   

bg   346   503   382   368   562   410   366   499   368   
     346   503   382   368   562   410   366   499   368   
     346   503   382   368   562   410   366   499   368   
     346   503   382   368   562   410   366   499   368   
