     A1    A2    A3    B1    B2    B3    C1    C2    C3    

A1   405   557   398   392   586   419   370   502   371   
     405   557   398   392   586   419   370   502   371   
     405   556   398   392   586   419   370   503   371   
     405   556   398   392   586   419   370   502   371   

bg   346   503   383   368   562   412   366   499   370   
     346   503   383   368   562   412   366   499   370   
     345   503   383   368   562   412   366   499   370   
     346   503   383   368   562   412   366   499   370   

A2   389   614   452   386   606   440   370   504   373   
     389   613   452   386   606   440   370   504   373   
     389   613   452   386   606   440   370   504   373   
     389   614   452   386   606   440   370   504   373   

bg   346   503   383   368   562   412   366   499   370   
     346   503   383   368   562   412   366   499   369   
     345   503   383   368   562   412   366   499   370   
     346   503   383   368   562   412   366   499   370   

A3   353   557   463   372   587   444   368   502   374   
     353   557   464   372   587   444   368   503   374   
     353   557   464   372   587   444   368   502   374   
     353   557   463   372   587   444   368   502   374   

bg   346   503   383   368   562   412   366   499   370   
     346   503   383   368   562   412   366   499   370   
     346   503   383   368   562   412   366   499   370   
     346   503   383   368   562   412   366   499   369   

B1   377   530   390   442   627   428   401   529   378   
     377   530   390   442   627   428   401   529   378   
     377   530   390   442   627   428   401   529   378   
     377   530   390   442   627   428   401   529   378   

bg   346   503   383   368   562   412   366   499   370   
     346   503   383   368   562   412   366   499   369   
     346   503   383   368   562   412   366   499   370   
     346   503   383   368   562   412   366   499   370   

B2   364   544   410   408   673   479   387   542   397   
     364   545   410   408   672   479   387   542   397   
     364   544   410   408   672   479   387   542   397   
     364   544   410   408   672   478   387   541   397   

bg   346   503   383   368   562   412   366   499   370   
     346   503   383   368   562   412   366   499   370   
     346   503   383   368   562   412   366   499   370   
     346   503   383   368   562   412   366   499   370   

B3   349   522   411   373   612   488   371   522   403   
     349   522   411   373   612   488   370   523   403   
     349   522   411   373   612   488   370   523   403   
     349   522   411   373   612   488   370   523   403   

bg   346   503   383   368   562   412   366   499   370   
     346   503   383   368   562   412   366   499   369   
     346   503   383   368   562   412   366   499   370   
     346   503   383   368   562   412   366   499   369   

C1   349   507   385   401   595   423   446   570   391   
     350   507   385   401   595   423   446   570   391   
     350   507   385   401   595   423   446   570   391   
     350   507   385   401   595   423   446   570   391   

bg   346   503   383   368   562   412   366   499   369   
     346   503   383   368   562   412   366   499   369   
     346   503   383   368   562   412   366   499   369   
     346   503   383   368   562   412   366   499   369   

C2   349   508   386   390   611   445   419   610   437   
     349   508   386   390   611   444   419   610   437   
     349   508   386   390   611   444   419   609   437   
     348   508   386   390   611   444   418   609   436   

bg   346   503   383   368   562   411   366   499   369   
     346   503   383   368   562   411   366   499   369   
     346   503   383   368   562   412   366   499   369   
     346   503   383   368   562   411   366   499   369   

C3   347   506   386   371   585   443   374   549   442   
     347   505   386   371   585   443   374   549   442   
     347   506   386   371   585   443   374   549   442   
     347   505   386   372   585   443   374   549   442   

bg   346   503   383   368   562   412   366   499   369   
     346   503   383   368   562   412   366   499   369   
     346   503   383   368   562   412   366   499   369   
     346   503   383   368   562   411   366   499   369   
