     A1    A2    A3    B1    B2    B3    C1    C2    C3    

A1   415   565   399   396   589   420   370   502   371   
     415   565   399   395   589   419   370   502   371   
     415   565   399   396   589   419   371   502   371   
     414   565   399   395   589   420   370   502   371   

bg   346   503   383   368   562   412   366   499   370   
     345   503   383   368   562   412   366   499   370   
     345   503   383   367   562   412   366   499   370   
     345   503   383   368   562   412   366   499   370   

A2   389   613   452   385   606   440   369   504   373   
     389   613   452   386   606   440   369   503   373   
     389   613   452   386   606   440   369   504   373   
     389   613   451   386   606   440   369   504   373   

bg   345   503   383   368   562   412   366   499   370   
     346   503   383   368   562   412   366   499   370   
     345   502   383   367   562   412   366   499   370   
     345   503   383   368   562   412   366   499   370   

A3   353   556   463   372   587   444   368   502   374   
     353   556   464   371   587   444   368   502   374   
     353   556   463   372   587   444   368   502   374   
     353   557   463   372   587   444   367   502   374   

bg   345   503   383   368   562   412   366   499   370   
     345   503   383   368   562   412   366   499   369   
     345   503   383   368   562   412   366   499   370   
     345   503   383   368   562   412   366   499   369   

B1   377   530   390   441   626   428   401   529   378   
     377   530   390   442   627   428   400   529   378   
     377   530   390   441   626   428   401   529   378   
     377   530   390   441   626   428   400   529   378   

bg   346   503   383   368   562   412   366   499   370   
     346   503   383   368   562   412   366   499   370   
     345   503   383   368   562   412   366   499   370   
     346   503   383   368   562   412   366   499   370   

B2   364   545   410   408   673   479   387   541   397   
     364   544   410   408   672   479   387   541   397   
     364   544   410   408   672   479   387   541   397   
     364   544   410   408   672   479   387   541   397   

bg   346   503   383   368   562   412   366   499   370   
     346   503   383   368   562   412   366   499   370   
     346   503   383   368   562   412   366   499   370   
     346   503   383   368   562   412   366   499   370   

B3   348   522   411   373   612   488   370   523   403   
     348   522   411   373   612   488   370   522   403   
     349   522   411   373   612   488   370   523   403   
     349   522   411   373   612   488   370   522   403   

bg   346   503   383   368   562   412   366   499   370   
     346   503   383   368   563   412   366   499   370   
     346   503   383   368   563   412   366   499   370   
     346   503   384   368   562   412   366   499   370   

C1   350   507   385   401   595   424   446   570   391   
     350   507   385   401   595   424   446   570   391   
     350   507   386   401   595   424   446   570   392   
     350   507   385   401   595   424   446   570   392   

bg   346   504   384   368   563   412   366   499   370   
     346   504   383   368   563   412   366   499   370   
     346   504   384   368   563   413   366   500   370   
     346   504   384   368   563   412   366   499   370   

C2   349   508   387   390   612   445   419   610   438   
     349   508   387   390   612   445   419   610   437   
     349   508   387   390   612   445   419   610   437   
     349   508   387   390   612   445   419   609   437   

bg   346   503   384   368   563   412   366   499   370   
     346   504   384   368   563   412   366   500   370   
     346   503   383   368   562   412   366   499   370   
     346   503   384   368   563   412   366   499   370   

C3   347   506   387   372   585   444   374   549   443   
     347   506   387   372   585   444   374   549   443   
     347   506   387   372   585   444   374   549   443   
     347   506   387   372   586   444   374   549   443   

bg   346   503   384   368   563   412   366   499   370   
     346   503   384   368   563   412   366   499   370   
     346   503   384   368   563   412   366   499   370   
     346   503   384   368   563   412   366   499   370   
