Trial #1-------------------------

     A1    A2    A3    B1    B2    B3    C1    C2    C3    

A1   83    74    17    32    30    8     4     3     2     
     82    74    17    31    30    8     4     3     2     
     82    74    17    31    29    8     4     3     2     
     82    74    17    31    29    8     4     3     2     

bg   0     0     0     0     0     0     0     0     0     
     0     0     0     0     0     0     0     0     0     
     0     0     0     0     0     0     0     0     0     
     0     0     0     0     0     0     0     0     0     

A2   47    122   73    19    48    29    3     5     4     
     46    122   73    19    48    29    3     5     4     
     46    122   73    19    48    29    3     5     4     
     46    122   73    19    48    29    3     5     4     

bg   0     0     0     0     0     0     0     0     0     
     0     0     0     0     0     0     0     0     0     
     0     0     0     0     0     0     0     0     0     
     0     0     0     0     0     0     0     0     0     

A3   6     53    89    3     23    31    2     3     4     
     6     53    89    3     23    31    2     3     4     
     6     53    89    3     23    31    2     3     4     
     6     53    90    3     23    31    2     3     4     

bg   0     0     0     0     0     0     0     0     0     
     0     0     0     0     0     0     0     0     0     
     0     0     0     0     0     0     0     0     0     
     0     0     0     0     0     0     0     0     0     

B1   31    29    8     79    69    17    34    30    9     
     31    29    8     79    69    17    34    30    9     
     31    29    8     79    69    17    34    30    9     
     31    29    8     79    69    17    34    30    9     

bg   0     0     0     0     0     0     0     0     0     
     0     0     0     0     0     0     0     0     0     
     0     0     0     0     0     0     0     0     0     
     0     0     0     0     0     0     0     0     0     

B2   20    48    30    44    123   74    19    42    29    
     20    48    30    44    123   74    19    42    29    
     20    48    30    44    123   74    19    42    29    
     20    48    30    44    123   74    19    42    29    

bg   0     0     0     0     0     0     0     0     0     
     0     0     0     0     0     0     0     0     0     
     0     0     0     0     0     0     0     0     0     
     0     0     0     0     0     0     0     0     0     

B3   3     23    34    6     58    90    4     26    40    
     3     23    34    6     58    90    4     26    40    
     3     23    34    6     58    90    4     26    40    
     3     23    34    6     58    90    4     26    40    

bg   0     0     0     0     0     0     0     0     0     
     0     0     0     0     0     0     0     0     0     
     0     0     0     0     0     0     0     0     0     
     0     0     0     0     0     0     0     0     0     

C1   4     4     2     34    31    10    85    79    20    
     4     4     2     34    31    10    84    78    20    
     4     4     2     34    31    10    84    78    20    
     4     4     2     33    31    10    84    78    20    

bg   0     0     0     0     0     0     0     0     0     
     0     0     0     0     0     0     0     0     0     
     0     0     0     0     0     0     0     0     0     
     0     0     0     0     0     0     0     0     0     

C2   3     4     3     19    45    32    51    125   72    
     3     4     3     19    45    32    51    125   72    
     3     4     3     19    45    32    51    125   72    
     3     4     3     19    45    32    51    124   72    

bg   0     0     0     0     0     0     0     0     0     
     0     0     0     0     0     0     0     0     0     
     0     0     0     0     0     0     0     0     0     
     0     0     0     0     0     0     0     0     0     

C3   2     3     3     3     22    35    6     55    87    
     2     3     3     3     22    35    6     55    87    
     2     3     3     3     22    35    6     55    87    
     2     3     3     3     22    35    6     55    87    

bg   0     0     0     0     0     0     0     0     0     
     0     0     0     0     0     0     0     0     0     
     0     0     0     0     0     0     0     0     0     
     0     0     0     0     0     0     0     0     0     


Trial #2-------------------------

     A1    A2    A3    B1    B2    B3    C1    C2    C3    

A1   83    74    17    32    29    8     5     3     2     
     82    74    17    32    29    8     5     3     2     
     82    74    17    32    29    8     5     3     2     
     82    74    17    32    29    8     5     3     2     

bg   0     0     0     1     0     0     0     0     0     
     0     0     0     1     0     0     0     0     0     
     0     0     0     1     0     0     0     0     0     
     0     0     0     1     0     0     0     0     0     

A2   47    122   73    19    48    29    3     5     4     
     46    122   73    19    48    29    3     5     4     
     46    122   73    19    48    29    3     5     4     
     46    121   73    19    48    29    3     5     4     

bg   0     0     0     0     0     0     0     0     0     
     0     0     0     0     0     0     0     0     0     
     0     0     0     0     0     0     0     0     0     
     0     0     0     0     0     0     0     0     0     

A3   6     53    90    3     23    32    2     3     4     
     6     53    90    3     23    32    2     3     4     
     6     53    90    3     23    32    2     3     4     
     6     53    90    3     23    32    2     3     4     

bg   0     0     0     0     0     0     0     0     0     
     0     0     0     0     0     0     0     0     0     
     0     0     0     0     0     0     0     0     0     
     0     0     0     0     0     0     0     0     0     

B1   31    29    8     79    69    17    34    30    9     
     31    29    8     79    69    17    34    30    9     
     31    29    8     79    69    17    34    30    9     
     31    29    8     79    69    17    34    30    9     

bg   0     0     0     0     0     0     0     0     0     
     0     0     0     0     0     0     0     0     0     
     0     0     0     0     0     0     0     0     0     
     0     0     0     0     0     0     0     0     0     

B2   20    48    30    44    122   74    19    42    29    
     20    48    30    44    122   73    19    42    29    
     20    48    30    44    122   73    19    42    29    
     20    48    30    44    122   73    19    42    29    

bg   0     0     0     1     0     0     0     0     0     
     0     0     0     1     0     0     0     0     0     
     0     0     0     1     0     0     0     0     0     
     0     0     0     1     0     0     0     0     0     

B3   4     23    34    6     58    90    5     26    40    
     4     23    34    6     58    90    5     26    40    
     4     23    34    6     58    89    5     26    40    
     4     23    34    6     58    89    5     26    39    

bg   0     0     0     1     0     0     0     0     0     
     0     0     0     1     0     0     0     0     0     
     0     0     0     1     0     0     0     0     0     
     0     0     0     1     0     0     0     0     0     

C1   4     4     2     34    31    11    85    79    20    
     4     4     2     34    31    11    85    78    20    
     4     4     2     34    31    11    85    78    20    
     4     4     2     34    31    11    85    78    20    

bg   0     0     0     1     0     0     0     0     0     
     0     0     0     1     0     0     0     0     0     
     0     0     0     1     0     0     0     0     0     
     0     0     0     1     0     0     0     0     0     

C2   3     4     3     20    45    32    51    125   72    
     3     4     3     20    45    32    51    125   72    
     3     4     3     20    45    32    51    125   72    
     3     4     3     20    45    32    51    125   72    

bg   0     0     0     1     0     0     0     0     0     
     0     0     0     1     0     0     0     0     0     
     0     0     0     1     0     0     0     0     0     
     0     0     0     1     0     0     0     0     0     

C3   2     3     3     3     22    35    6     55    87    
     2     3     3     3     22    35    6     55    88    
     2     3     3     3     22    35    6     55    88    
     2     3     3     3     22    35    6     55    88    

bg   0     0     0     0     0     0     0     0     0     
     0     0     0     0     0     0     0     0     0     
     0     0     0     0     0     0     0     0     0     
     0     0     0     0     0     0     0     0     0     


Trial #3-------------------------

     A1    A2    A3    B1    B2    B3    C1    C2    C3    

A1   83    74    17    32    30    8     5     3     2     
     83    74    17    32    29    8     4     3     2     
     82    74    17    32    29    8     4     3     2     
     82    74    17    31    29    8     4     3     2     

bg   0     0     0     0     0     0     0     0     0     
     0     0     0     0     0     0     0     0     0     
     0     0     0     0     0     0     0     0     0     
     0     0     0     0     0     0     0     0     0     

A2   47    122   73    19    48    29    3     5     4     
     47    122   73    19    48    29    3     5     4     
     47    122   73    19    48    29    3     5     4     
     47    122   73    19    48    29    3     5     4     

bg   0     0     0     0     0     0     0     0     0     
     0     0     0     0     0     0     0     0     0     
     0     0     0     0     0     0     0     0     0     
     0     0     0     0     0     0     0     0     0     

A3   6     53    90    3     23    32    2     3     4     
     6     53    90    3     23    32    2     3     4     
     6     53    90    3     23    32    2     3     4     
     6     53    90    3     23    32    2     3     4     

bg   0     0     0     0     0     0     0     0     0     
     0     0     0     0     0     0     0     0     0     
     0     0     0     0     0     0     0     0     0     
     0     0     0     0     0     0     0     0     0     

B1   31    29    8     79    69    17    34    30    9     
     31    29    8     79    69    17    34    30    9     
     31    29    8     79    69    17    34    30    9     
     31    29    8     79    69    17    34    30    9     

bg   0     0     0     0     0     0     0     0     0     
     0     0     0     0     0     0     0     0     0     
     0     0     0     0     0     0     0     0     0     
     0     0     0     0     0     0     0     0     0     

B2   20    48    30    44    123   74    19    42    29    
     20    48    30    44    122   74    19    42    29    
     20    48    30    44    122   73    19    42    29    
     20    48    30    44    122   73    19    42    29    

bg   0     0     0     0     0     0     0     0     0     
     0     0     0     0     0     0     0     0     0     
     0     0     0     0     0     0     0     0     0     
     0     0     0     0     0     0     0     0     0     

B3   4     23    34    6     58    90    4     26    40    
     4     23    34    6     58    89    4     26    40    
     4     23    34    6     58    89    4     26    40    
     4     23    34    6     58    89    4     26    40    

bg   0     0     0     0     0     0     0     0     0     
     0     0     0     0     0     0     0     0     0     
     0     0     0     0     0     0     0     0     0     
     0     0     0     0     0     0     0     0     0     

C1   4     4     2     34    31    10    84    78    20    
     4     4     2     34    31    10    84    78    20    
     4     4     2     34    31    10    84    78    20    
     4     4     2     34    31    10    84    78    20    

bg   0     0     0     0     0     0     0     0     0     
     0     0     0     0     0     0     0     0     0     
     0     0     0     0     0     0     0     0     0     
     0     0     0     0     0     0     0     0     0     

C2   3     4     3     19    44    32    51    124   72    
     3     4     3     19    44    32    51    124   72    
     3     4     3     19    44    32    51    124   72    
     3     4     3     19    44    32    51    124   72    

bg   0     0     0     0     0     0     0     0     0     
     0     0     0     0     0     0     0     0     0     
     0     0     0     0     0     0     0     0     0     
     0     0     0     0     0     0     0     0     0     

C3   2     3     3     3     22    36    6     55    88    
     2     3     3     3     22    36    6     55    88    
     2     3     3     3     22    36    6     55    88    
     2     3     3     3     22    36    6     55    88    

bg   0     0     0     0     0     0     0     0     0     
     0     0     0     0     0     0     0     0     0     
     0     0     0     0     0     0     0     0     0     
     0     0     0     0     0     0     0     0     0     


Trial #4-------------------------

     A1    A2    A3    B1    B2    B3    C1    C2    C3    

A1   83    74    17    32    30    8     5     3     2     
     82    74    17    32    29    8     5     3     2     
     82    74    17    32    29    8     5     3     2     
     82    74    17    31    29    8     4     3     2     

bg   0     0     0     0     0     0     0     0     0     
     0     0     0     0     0     0     0     0     0     
     0     0     0     0     0     0     0     0     0     
     0     0     0     0     0     0     0     0     0     

A2   47    122   73    19    48    29    3     5     4     
     47    122   73    19    48    29    3     5     4     
     47    122   73    19    48    29    3     5     4     
     47    122   73    19    48    29    3     5     4     

bg   0     0     0     0     0     0     0     0     0     
     0     0     0     0     0     0     0     0     0     
     0     0     0     0     0     0     0     0     0     
     0     0     0     0     0     0     0     0     0     

A3   6     53    90    3     23    32    2     3     4     
     6     53    90    3     23    32    2     3     4     
     6     53    90    3     23    32    2     3     4     
     6     53    90    3     23    32    2     3     4     

bg   0     0     0     0     0     0     0     0     0     
     0     0     0     0     0     0     0     0     0     
     0     0     0     0     0     0     0     0     0     
     0     0     0     0     0     0     0     0     0     

B1   31    29    8     79    69    17    34    30    9     
     31    29    8     79    69    17    34    30    9     
     31    29    8     79    69    17    34    30    9     
     31    29    8     79    69    17    34    30    9     

bg   0     0     0     0     0     0     0     0     0     
     0     0     0     0     0     0     0     0     0     
     0     0     0     0     0     0     0     0     0     
     0     0     0     0     0     0     0     0     0     

B2   20    48    30    44    123   74    19    42    29    
     20    48    30    44    122   74    19    42    29    
     20    48    30    44    122   74    19    42    29    
     20    48    30    44    122   73    19    42    29    

bg   0     0     0     0     0     0     0     0     0     
     0     0     0     0     0     0     0     0     0     
     0     0     0     0     0     0     0     0     0     
     0     0     0     0     0     0     0     0     0     

B3   4     23    34    6     58    90    4     26    40    
     4     23    35    6     58    90    4     26    40    
     4     24    35    6     58    90    4     26    40    
     3     24    35    6     58    90    4     26    40    

bg   0     0     0     0     0     0     0     0     0     
     0     0     0     0     0     0     0     0     0     
     0     0     0     0     0     0     0     0     0     
     0     0     0     0     0     0     0     0     0     

C1   4     4     2     34    31    10    85    78    20    
     4     4     2     34    31    10    84    78    20    
     4     4     2     34    31    10    84    78    20    
     4     4     2     34    31    10    84    78    20    

bg   0     0     0     0     0     0     0     0     0     
     0     0     0     0     0     0     0     0     0     
     0     0     0     0     0     0     0     0     0     
     0     0     0     0     0     0     0     0     0     

C2   2     4     3     19    44    32    51    124   72    
     2     4     3     19    44    32    51    124   72    
     3     4     3     19    44    32    51    124   72    
     3     4     3     19    44    32    51    124   72    

bg   0     0     0     0     0     0     0     0     0     
     0     0     0     0     0     0     0     0     0     
     0     0     0     0     0     0     0     0     0     
     0     0     0     0     0     0     0     0     0     

C3   2     3     3     3     22    36    6     55    88    
     2     3     3     3     22    35    6     55    88    
     2     3     3     3     22    35    6     55    88    
     2     3     3     3     22    35    6     55    88    

bg   0     0     0     0     0     0     0     0     0     
     0     0     0     0     0     0     0     0     0     
     0     0     0     0     0     0     0     0     0     
     0     0     0     0     0     0     0     0     0     


