Trial #1-------------------------

     A1    A2    A3    B1    B2    B3    C1    C2    C3    

A1   83    75    17    32    30    8     4     3     2     
     83    74    17    32    29    8     4     3     2     
     83    74    17    31    29    8     4     3     2     
     82    74    17    31    29    8     4     3     2     

bg   0     0     0     0     0     0     0     0     0     
     0     0     0     0     0     0     0     0     0     
     0     0     0     0     0     0     0     0     0     
     0     0     0     0     0     0     0     0     0     

A2   46    123   73    19    48    29    3     4     4     
     46    123   73    19    48    29    3     4     4     
     46    123   73    19    48    29    3     4     4     
     46    123   73    19    48    29    3     4     4     

bg   0     0     0     0     0     0     0     0     0     
     0     0     0     0     0     0     0     0     0     
     0     0     0     0     0     0     0     0     0     
     0     0     0     0     0     0     0     0     0     

A3   6     53    92    3     23    32    2     3     4     
     6     53    91    3     23    32    1     3     4     
     6     53    91    3     23    32    2     3     4     
     6     53    91    3     23    32    1     3     4     

bg   0     0     0     0     0     0     0     0     0     
     0     0     0     0     0     0     0     0     0     
     0     0     0     0     0     0     0     0     0     
     0     0     0     0     0     0     0     0     0     

B1   31    29    8     79    69    17    34    30    9     
     31    29    8     79    69    17    34    30    9     
     31    29    8     79    69    17    34    30    9     
     31    29    8     79    69    17    34    30    9     

bg   0     0     0     0     0     0     0     0     0     
     0     0     0     0     0     0     0     0     0     
     0     0     0     0     0     0     0     0     0     
     0     0     0     0     0     0     0     0     0     

B2   20    48    30    44    124   75    19    43    29    
     20    48    30    44    124   75    19    43    29    
     20    48    30    44    124   74    19    42    29    
     20    48    30    44    124   74    19    42    29    

bg   0     0     0     0     0     0     0     0     0     
     0     0     0     0     0     0     0     0     0     
     0     0     0     0     0     0     0     0     0     
     0     0     0     0     0     0     0     0     0     

B3   3     23    34    6     58    91    4     26    40    
     3     23    34    6     58    91    4     26    40    
     3     23    34    6     58    91    4     26    40    
     3     23    34    6     58    91    4     26    40    

bg   0     0     0     0     0     0     0     0     0     
     0     0     0     0     0     0     0     0     0     
     0     0     0     0     0     0     0     0     0     
     0     0     0     0     0     0     0     0     0     

C1   4     4     2     33    30    10    84    78    20    
     4     4     2     33    30    10    84    78    20    
     4     4     2     33    30    10    84    78    20    
     4     4     2     33    30    10    84    78    20    

bg   0     0     0     0     0     0     0     0     0     
     0     0     0     0     0     0     0     0     0     
     0     0     0     0     0     0     0     0     0     
     0     0     0     0     0     0     0     0     0     

C2   2     4     3     19    44    31    51    125   72    
     2     4     3     19    44    31    51    125   72    
     2     4     3     19    44    31    51    125   72    
     2     4     3     19    44    31    51    125   72    

bg   0     0     0     0     0     0     0     0     0     
     0     0     0     0     0     0     0     0     0     
     0     0     0     0     0     0     0     0     0     
     0     0     0     0     0     0     0     0     0     

C3   1     3     4     3     22    36    6     55    90    
     1     3     4     3     22    36    6     55    90    
     1     3     4     3     22    36    6     55    90    
     1     3     4     3     22    36    6     55    89    

bg   0     0     0     0     0     0     0     0     0     
     0     0     0     0     0     0     0     0     0     
     0     0     0     0     0     0     0     0     0     
     0     0     0     0     0     0     0     0     0     


Trial #2-------------------------

     A1    A2    A3    B1    B2    B3    C1    C2    C3    

A1   83    75    17    32    30    8     4     3     2     
     83    75    17    32    29    8     4     3     2     
     83    74    17    31    29    8     4     3     2     
     82    74    17    31    29    8     4     3     2     

bg   0     0     0     0     0     0     0     0     0     
     0     0     0     0     0     0     0     0     0     
     0     0     0     0     0     0     0     0     0     
     0     0     0     0     0     0     0     0     0     

A2   46    123   73    19    48    29    3     4     4     
     46    123   73    19    48    29    3     4     4     
     46    123   73    19    48    29    3     5     4     
     46    123   73    19    48    29    3     4     4     

bg   0     0     0     0     0     0     0     0     0     
     0     0     0     0     0     0     0     0     0     
     0     0     0     0     0     0     0     0     0     
     0     0     0     0     0     0     0     0     0     

A3   6     53    92    3     23    32    2     3     4     
     6     53    91    3     23    32    2     3     4     
     6     53    91    3     23    32    2     3     4     
     6     53    91    3     23    32    2     3     4     

bg   0     0     0     0     0     0     0     0     0     
     0     0     0     0     0     0     0     0     0     
     0     0     0     0     0     0     0     0     0     
     0     0     0     0     0     0     0     0     0     

B1   31    29    8     79    69    17    34    30    9     
     31    29    8     79    69    17    34    30    9     
     31    29    8     79    69    17    34    30    9     
     31    29    8     79    69    17    34    30    9     

bg   0     0     0     0     0     0     0     0     0     
     0     0     0     0     0     0     0     0     0     
     0     0     0     0     0     0     0     0     0     
     0     0     0     0     0     0     0     0     0     

B2   20    48    30    44    124   74    19    42    29    
     20    48    30    44    124   74    19    42    29    
     20    48    30    44    124   74    19    42    29    
     20    48    30    44    123   74    19    42    29    

bg   0     0     0     0     0     0     0     0     0     
     0     0     0     0     0     0     0     0     0     
     0     0     0     0     0     0     0     0     0     
     0     0     0     0     0     0     0     0     0     

B3   3     23    34    6     58    91    4     26    40    
     3     23    34    6     58    91    4     26    40    
     3     23    34    6     58    91    4     26    40    
     3     23    34    6     58    91    4     26    40    

bg   0     0     0     0     0     0     0     0     0     
     0     0     0     0     0     0     0     0     0     
     0     0     0     0     0     0     0     0     0     
     0     0     0     0     0     0     0     0     0     

C1   4     4     2     33    31    10    85    79    20    
     4     4     2     33    31    10    85    79    20    
     4     4     2     33    31    10    84    79    20    
     4     4     2     33    30    10    84    78    20    

bg   0     0     0     0     0     0     0     0     0     
     0     0     0     0     0     0     0     0     0     
     0     0     0     0     0     0     0     0     0     
     0     0     0     0     0     0     0     0     0     

C2   2     4     3     19    44    31    51    125   72    
     2     4     3     19    44    31    51    125   72    
     2     4     3     19    44    31    51    125   72    
     2     4     3     19    44    31    51    125   72    

bg   0     0     0     0     0     0     0     0     0     
     0     0     0     0     0     0     0     0     0     
     0     0     0     0     0     0     0     0     0     
     0     0     0     0     0     0     0     0     0     

C3   1     3     4     3     22    36    6     55    89    
     1     3     4     3     22    36    6     55    89    
     1     3     4     3     22    36    6     55    89    
     1     3     4     3     22    36    6     55    89    

bg   0     0     0     0     0     0     0     0     0     
     0     0     0     0     0     0     0     0     0     
     0     0     0     0     0     0     0     0     0     
     0     0     0     0     0     0     0     0     0     


Trial #3-------------------------

     A1    A2    A3    B1    B2    B3    C1    C2    C3    

A1   83    75    17    32    30    8     4     3     2     
     83    75    17    32    30    8     4     3     2     
     83    74    17    31    29    8     4     3     2     
     82    74    17    31    29    8     4     3     2     

bg   0     0     0     0     0     0     0     0     0     
     0     0     0     0     0     0     0     0     0     
     0     0     0     0     0     0     0     0     0     
     0     0     0     0     0     0     0     0     0     

A2   47    123   74    19    48    29    3     5     4     
     46    123   74    19    48    29    3     5     4     
     46    123   73    19    48    29    3     5     4     
     46    123   73    19    48    29    3     4     4     

bg   0     0     0     0     0     0     0     0     0     
     0     0     0     0     0     0     0     0     0     
     0     0     0     0     0     0     0     0     0     
     0     0     0     0     0     0     0     0     0     

A3   6     53    92    3     23    32    2     3     4     
     6     53    92    3     23    32    2     3     4     
     6     53    91    3     23    32    2     3     4     
     6     53    91    3     23    32    2     3     4     

bg   0     0     0     0     0     0     0     0     0     
     0     0     0     0     0     0     0     0     0     
     0     0     0     0     0     0     0     0     0     
     0     0     0     0     0     0     0     0     0     

B1   31    29    8     79    70    17    34    30    9     
     31    29    8     79    70    17    34    30    9     
     31    29    8     79    69    17    34    30    9     
     31    29    8     79    69    17    34    30    9     

bg   0     0     0     0     0     0     0     0     0     
     0     0     0     0     0     0     0     0     0     
     0     0     0     0     0     0     0     0     0     
     0     0     0     0     0     0     0     0     0     

B2   20    48    30    44    124   74    19    42    29    
     20    48    30    44    124   74    19    42    29    
     20    48    30    44    124   74    19    42    29    
     20    48    30    44    123   74    19    42    29    

bg   0     0     0     0     0     0     0     0     0     
     0     0     0     0     0     0     0     0     0     
     0     0     0     0     0     0     0     0     0     
     0     0     0     0     0     0     0     0     0     

B3   3     23    34    6     58    91    4     26    40    
     3     23    34    6     58    91    4     26    40    
     3     23    35    6     58    91    4     26    40    
     3     23    34    6     58    91    4     26    40    

bg   0     0     0     0     0     0     0     0     0     
     0     0     0     0     0     0     0     0     0     
     0     0     0     0     0     0     0     0     0     
     0     0     0     0     0     0     0     0     0     

C1   4     4     2     34    31    10    85    79    20    
     4     4     2     34    31    10    85    79    20    
     4     4     2     34    31    10    85    79    20    
     4     4     2     34    31    10    84    79    20    

bg   0     0     0     0     0     0     0     0     0     
     0     0     0     0     0     0     0     0     0     
     0     0     0     0     0     0     0     0     0     
     0     0     0     0     0     0     0     0     0     

C2   2     4     3     19    44    31    51    125   73    
     2     4     3     19    44    31    51    125   73    
     2     4     3     19    44    31    51    125   73    
     2     4     3     19    44    31    51    125   72    

bg   0     0     0     0     0     0     0     0     0     
     0     0     0     0     0     0     0     0     0     
     0     0     0     0     0     0     0     0     0     
     0     0     0     0     0     0     0     0     0     

C3   1     3     4     3     22    36    6     55    89    
     1     3     4     3     22    36    6     55    89    
     1     3     4     3     22    36    6     55    89    
     1     3     4     3     22    36    6     55    89    

bg   0     0     0     0     0     0     0     0     0     
     0     0     0     0     0     0     0     0     0     
     0     0     0     0     0     0     0     0     0     
     0     0     0     0     0     0     0     0     0     


Trial #4-------------------------

     A1    A2    A3    B1    B2    B3    C1    C2    C3    

A1   83    75    17    32    30    8     4     3     2     
     83    75    17    32    30    8     4     3     2     
     83    75    17    31    30    8     4     3     2     
     83    74    17    31    29    8     4     3     2     

bg   0     0     0     0     0     0     0     0     0     
     0     0     0     0     0     0     0     0     0     
     0     0     0     0     0     0     0     0     0     
     0     0     0     0     0     0     0     0     0     

A2   47    124   74    19    48    29    3     5     4     
     47    123   74    19    48    29    3     5     4     
     47    123   74    19    48    29    3     5     4     
     47    123   73    19    48    29    3     5     4     

bg   0     0     0     0     0     0     0     0     0     
     0     0     0     0     0     0     0     0     0     
     0     0     0     0     0     0     0     0     0     
     0     0     0     0     0     0     0     0     0     

A3   6     53    91    3     23    32    2     3     4     
     6     53    91    3     23    32    2     3     4     
     6     53    91    3     23    32    2     3     4     
     6     53    91    3     23    32    2     3     4     

bg   0     0     0     0     0     0     0     0     0     
     0     0     0     0     0     0     0     0     0     
     0     0     0     0     0     0     0     0     0     
     0     0     0     0     0     0     0     0     0     

B1   31    29    8     79    70    17    34    30    9     
     31    29    8     79    70    17    34    30    9     
     31    29    8     79    70    17    34    30    9     
     31    29    8     79    70    17    34    30    9     

bg   0     0     0     0     0     0     0     0     0     
     0     0     0     0     0     0     0     0     0     
     0     0     0     0     0     0     0     0     0     
     0     0     0     0     0     0     0     0     0     

B2   20    48    30    44    124   74    19    42    29    
     20    48    30    44    124   74    19    42    29    
     20    48    30    44    123   74    19    42    29    
     20    48    30    44    123   74    19    42    29    

bg   0     0     0     0     0     0     0     0     0     
     0     0     0     0     0     0     0     0     0     
     0     0     0     0     0     0     0     0     0     
     0     0     0     0     0     0     0     0     0     

B3   3     23    34    6     58    91    4     26    40    
     3     23    34    6     58    91    4     26    40    
     3     23    34    6     58    91    4     26    40    
     3     23    34    6     58    91    4     26    40    

bg   0     0     0     0     0     0     0     0     0     
     0     0     0     0     0     0     0     0     0     
     0     0     0     0     0     0     0     0     0     
     0     0     0     0     0     0     0     0     0     

C1   4     4     2     34    31    10    85    79    20    
     4     4     2     34    31    10    85    79    20    
     4     4     2     34    31    10    85    79    20    
     4     4     2     34    31    10    84    79    20    

bg   0     0     0     0     0     0     0     0     0     
     0     0     0     0     0     0     0     0     0     
     0     0     0     0     0     0     0     0     0     
     0     0     0     0     0     0     0     0     0     

C2   2     4     3     19    44    32    51    126   73    
     2     4     3     19    44    32    51    126   73    
     2     4     3     19    44    32    51    125   73    
     2     4     3     19    44    32    51    125   73    

bg   0     0     0     0     0     0     0     0     0     
     0     0     0     0     0     0     0     0     0     
     0     0     0     0     0     0     0     0     0     
     0     0     0     0     0     0     0     0     0     

C3   1     3     4     3     22    36    6     55    89    
     1     3     4     3     22    36    6     55    89    
     1     3     4     3     22    36    6     55    89    
     1     3     4     3     22    36    6     55    89    

bg   0     0     0     0     0     0     0     0     0     
     0     0     0     0     0     0     0     0     0     
     0     0     0     0     0     0     0     0     0     
     0     0     0     0     0     0     0     0     0     


