Trial #1-------------------------

     A1    A2    A3    B1    B2    B3    C1    C2    C3    

A1   135   153   100   101   140   112   102   151   135   
     135   153   100   100   140   112   102   151   136   
     134   153   100   100   140   112   102   151   136   
     134   153   100   100   140   112   102   151   136   

bg   59    83    82    70    110   104   98    149   135   
     60    83    82    70    111   105   99    150   136   
     60    83    83    71    111   105   100   150   136   
     60    84    83    71    112   105   100   151   136   

A2   107   197   152   91    160   134   103   155   139   
     107   197   152   91    159   134   103   155   139   
     106   196   152   90    159   133   102   154   139   
     106   196   151   90    158   133   102   153   138   

bg   59    82    82    69    110   104   98    148   135   
     59    82    81    69    109   103   98    148   134   
     59    82    81    69    110   103   98    148   134   
     59    82    81    70    110   104   98    148   134   

A3   66    133   165   73    133   134   100   151   138   
     66    133   165   73    133   134   100   151   138   
     66    133   165   73    133   134   100   151   138   
     66    133   165   73    133   134   100   151   138   

bg   59    82    81    70    110   103   98    148   134   
     59    82    81    69    110   103   98    148   134   
     59    82    81    69    109   103   98    148   134   
     59    82    81    69    109   103   98    148   134   

B1   89    111   90    144   177   121   131   178   143   
     89    111   90    144   177   121   131   178   143   
     89    111   90    144   177   121   131   179   143   
     89    111   90    144   177   121   131   179   143   

bg   59    82    81    70    110   103   98    148   134   
     59    82    81    70    110   103   98    148   134   
     59    82    81    70    110   103   98    148   134   
     59    82    81    70    110   103   98    148   134   

B2   79    128   111   113   226   175   117   189   163   
     79    128   111   113   226   175   117   189   163   
     79    129   111   113   226   175   117   189   163   
     79    129   111   113   226   174   117   190   163   

bg   59    82    81    70    109   103   98    148   134   
     59    82    81    70    110   103   98    148   134   
     59    82    81    70    110   103   98    148   134   
     59    82    81    70    110   103   98    148   134   

B3   63    105   115   76    166   189   102   174   173   
     63    105   115   76    166   190   102   174   174   
     63    105   115   76    166   190   102   174   174   
     63    105   115   76    166   190   102   174   174   

bg   59    82    81    70    110   104   98    148   134   
     59    82    81    70    110   103   98    148   134   
     59    82    81    70    110   103   98    148   134   
     59    82    81    70    110   103   98    148   134   

C1   63    86    83    103   140   114   180   225   154   
     62    86    83    103   140   114   180   225   154   
     62    86    83    102   140   114   179   224   154   
     62    86    83    102   140   114   179   224   154   

bg   59    82    81    69    110   104   98    148   134   
     59    82    81    69    110   104   98    148   134   
     59    82    81    70    110   104   98    148   134   
     59    82    81    70    110   103   98    148   134   

C2   62    86    84    90    155   135   149   272   206   
     62    86    84    90    155   135   149   272   206   
     62    86    84    90    155   135   149   272   206   
     62    86    84    90    155   135   149   271   206   

bg   59    82    81    70    110   103   98    148   134   
     59    82    81    69    110   103   98    148   134   
     59    82    81    69    109   103   98    148   134   
     59    82    81    69    109   103   97    147   134   

C3   60    84    84    72    131   137   103   200   219   
     60    84    84    72    131   137   103   201   219   
     60    84    84    72    131   137   104   201   218   
     60    84    84    72    130   136   104   200   215   

bg   59    82    81    70    110   103   99    149   134   
     60    82    82    70    110   104   99    149   135   
     59    82    82    70    110   104   99    149   135   
     59    82    82    70    110   104   99    149   135   


Trial #2-------------------------

     A1    A2    A3    B1    B2    B3    C1    C2    C3    

A1   135   154   101   101   141   113   102   152   137   
     135   154   101   101   141   113   102   152   137   
     135   154   101   101   141   113   103   152   137   
     134   153   100   101   140   113   103   152   137   

bg   59    82    81    69    109   103   98    147   133   
     59    82    81    69    109   103   98    147   133   
     59    82    81    69    109   103   98    147   133   
     59    82    81    70    109   103   98    148   133   

A2   106   195   151   90    158   133   101   153   138   
     106   195   151   89    158   133   101   153   138   
     105   195   151   89    157   133   101   153   138   
     105   195   151   89    158   133   101   153   138   

bg   59    82    81    70    110   103   98    148   134   
     59    82    81    70    110   103   98    148   134   
     59    82    81    70    110   103   98    148   134   
     59    82    81    70    110   103   98    148   134   

A3   66    133   165   73    133   134   100   151   138   
     66    133   165   73    133   134   100   151   138   
     66    133   165   73    133   135   99    151   138   
     66    133   165   73    133   135   99    151   138   

bg   59    82    82    70    110   104   98    148   135   
     59    82    82    70    110   104   98    149   135   
     59    82    82    70    110   104   98    149   135   
     59    82    82    70    110   104   98    148   134   

B1   89    111   89    144   177   120   131   178   142   
     89    111   89    144   177   120   131   178   142   
     89    111   89    144   177   120   131   178   142   
     89    111   89    144   177   120   131   178   142   

bg   59    82    81    69    109   103   98    148   134   
     59    82    81    69    109   103   98    148   134   
     59    82    81    69    109   103   98    148   134   
     59    82    81    69    109   103   98    148   134   

B2   80    129   111   113   227   175   117   190   163   
     80    129   111   113   227   175   118   190   163   
     80    129   111   114   227   175   118   190   163   
     80    129   111   114   227   175   118   190   163   

bg   59    82    81    70    110   103   98    148   134   
     59    82    81    70    110   103   98    148   134   
     59    82    81    69    109   103   98    148   134   
     59    82    81    69    109   103   98    148   134   

B3   63    105   115   76    166   190   102   173   173   
     63    105   115   76    166   190   102   173   173   
     63    105   115   76    166   189   102   173   173   
     63    105   115   76    166   189   102   173   173   

bg   59    82    81    70    109   103   98    148   133   
     59    82    81    70    109   103   98    148   133   
     59    82    81    69    109   103   98    148   133   
     59    82    81    69    109   103   98    148   133   

C1   62    85    83    102   140   114   179   224   154   
     62    85    83    102   140   114   178   224   154   
     62    85    83    102   140   114   178   224   154   
     62    85    83    102   140   114   178   224   154   

bg   59    82    81    69    109   103   98    147   133   
     59    82    81    69    109   103   98    147   133   
     59    81    81    69    109   103   98    147   133   
     59    81    81    69    109   102   98    147   133   

C2   61    86    84    89    154   135   149   271   206   
     61    86    84    89    154   135   149   271   206   
     61    86    84    89    154   135   149   271   206   
     61    86    84    89    154   135   149   271   206   

bg   59    81    81    69    109   103   97    147   133   
     59    81    81    69    109   103   97    147   133   
     59    81    81    69    109   103   97    147   133   
     59    81    81    69    109   103   97    147   133   

C3   60    84    84    73    131   137   104   201   218   
     60    84    84    73    132   137   104   201   218   
     60    84    84    73    132   137   104   201   218   
     60    84    85    73    132   137   104   201   219   

bg   59    82    81    69    109   103   98    148   134   
     59    82    81    69    109   103   98    148   134   
     59    82    81    69    109   103   98    148   134   
     59    82    81    69    109   103   98    148   134   


Trial #3-------------------------

     A1    A2    A3    B1    B2    B3    C1    C2    C3    

A1   135   153   100   100   140   112   102   151   136   
     135   153   100   101   140   112   102   151   136   
     135   153   100   101   140   112   102   151   136   
     134   153   100   101   140   112   102   151   136   

bg   59    82    81    70    109   103   98    148   134   
     59    82    81    69    109   103   98    148   134   
     59    82    81    69    109   103   98    148   134   
     59    82    81    69    109   103   98    148   134   

A2   105   195   151   89    157   133   101   152   138   
     105   195   151   89    157   133   101   152   138   
     105   195   150   89    157   133   101   152   138   
     105   195   150   89    157   132   101   152   137   

bg   59    81    80    69    109   102   97    146   132   
     58    81    80    69    108   102   97    146   132   
     58    81    80    69    108   102   97    146   132   
     59    81    81    69    109   102   97    147   133   

A3   66    133   166   72    132   134   99    150   138   
     66    133   166   72    132   134   99    150   138   
     65    133   165   72    132   134   99    150   138   
     65    133   165   72    132   134   99    150   138   

bg   59    81    81    69    109   103   98    147   133   
     59    81    81    69    109   103   98    147   133   
     59    81    81    69    109   103   98    147   133   
     59    81    81    69    109   103   98    147   133   

B1   89    111   89    144   177   120   131   178   142   
     89    111   89    144   176   120   130   178   142   
     89    111   89    144   176   120   130   178   142   
     89    111   89    143   176   121   130   178   143   

bg   59    81    81    69    109   103   97    147   134   
     59    82    81    69    109   103   97    147   134   
     59    82    81    69    109   103   98    147   134   
     59    82    81    69    109   103   98    147   134   

B2   80    129   111   113   227   174   117   190   163   
     80    129   111   113   227   174   118   190   163   
     80    129   111   113   227   174   118   190   163   
     80    129   111   113   226   174   117   190   163   

bg   59    82    81    69    110   103   98    148   134   
     59    82    81    69    110   103   98    148   134   
     59    82    81    69    110   103   98    148   134   
     59    82    81    69    110   104   98    148   134   

B3   63    105   115   76    167   190   103   174   173   
     63    105   115   76    166   189   103   174   173   
     63    105   115   76    166   189   103   174   173   
     63    105   115   76    166   189   103   174   173   

bg   59    82    81    70    110   103   98    148   134   
     59    82    81    70    109   103   98    148   134   
     59    82    81    69    109   103   98    148   134   
     59    82    81    69    109   103   98    148   134   

C1   62    85    83    102   140   114   178   224   154   
     62    85    83    102   140   114   178   224   154   
     62    85    83    102   140   114   178   223   154   
     62    85    83    102   140   113   178   223   154   

bg   59    82    81    69    109   103   98    147   133   
     59    82    81    69    109   103   98    147   133   
     59    82    81    70    109   103   98    148   134   
     59    82    81    70    110   103   98    148   134   

C2   62    86    85    90    155   136   150   273   208   
     62    86    85    90    155   136   149   272   207   
     61    86    84    89    154   135   149   271   206   
     61    85    84    89    154   135   148   270   206   

bg   59    81    81    69    109   103   98    147   133   
     59    82    81    69    109   103   98    147   133   
     59    82    81    70    110   103   98    148   134   
     59    82    81    70    110   103   98    148   134   

C3   61    85    85    73    133   139   105   203   220   
     61    85    85    73    133   139   105   203   221   
     61    85    85    73    133   139   105   203   221   
     61    85    85    73    133   139   105   203   221   

bg   59    82    81    70    110   104   98    148   134   
     59    82    81    70    110   103   98    148   134   
     59    82    81    70    110   103   98    148   134   
     59    82    81    70    110   103   98    148   134   


Trial #4-------------------------

     A1    A2    A3    B1    B2    B3    C1    C2    C3    

A1   135   154   100   101   141   112   102   151   136   
     135   153   100   101   140   112   102   151   136   
     135   153   100   101   140   112   102   151   136   
     134   153   100   101   140   112   102   151   136   

bg   59    82    81    69    110   103   98    148   134   
     59    82    81    69    109   103   98    148   134   
     59    82    81    69    109   103   98    148   134   
     59    82    81    69    109   103   98    148   134   

A2   106   195   151   89    157   132   101   152   137   
     106   195   150   89    157   132   101   152   137   
     106   195   150   89    157   132   101   152   137   
     106   195   150   89    157   132   101   152   137   

bg   59    81    81    69    109   103   98    147   133   
     59    81    81    69    109   103   97    147   133   
     59    81    81    69    109   103   97    147   133   
     59    81    81    69    109   103   97    147   133   

A3   66    133   166   73    133   134   99    150   138   
     66    133   166   73    133   134   99    150   138   
     66    133   165   73    133   134   99    150   138   
     66    133   165   73    133   134   99    150   138   

bg   59    82    81    70    110   103   98    148   134   
     59    82    81    70    110   103   98    148   134   
     59    82    81    70    110   103   98    148   134   
     59    82    81    70    110   103   98    148   134   

B1   89    111   90    144   177   121   131   179   143   
     89    111   90    144   177   121   131   178   143   
     89    111   90    144   177   121   131   179   143   
     89    111   90    144   177   121   131   179   143   

bg   59    82    81    70    110   103   98    148   134   
     59    82    81    70    110   103   98    148   134   
     59    82    81    70    110   103   98    148   134   
     59    82    81    70    110   103   98    148   134   

B2   80    129   111   113   227   175   117   190   163   
     80    129   111   113   227   175   117   190   163   
     80    129   111   113   226   175   117   190   163   
     80    129   111   113   226   175   117   190   163   

bg   59    82    81    69    109   103   98    148   134   
     59    82    81    70    110   103   98    148   134   
     59    82    81    70    110   103   98    148   134   
     59    82    81    70    110   103   98    148   134   

B3   63    105   115   76    166   189   103   174   173   
     63    105   115   76    166   189   103   174   173   
     63    105   115   76    166   189   102   174   173   
     63    105   115   76    166   189   102   174   173   

bg   59    82    81    69    109   103   98    147   134   
     59    82    81    69    109   103   97    147   134   
     59    82    81    69    109   103   97    147   134   
     59    82    81    69    109   103   98    147   134   

C1   62    85    83    102   140   113   179   224   154   
     62    85    83    102   139   113   178   223   153   
     62    85    82    102   139   113   178   223   153   
     62    85    82    102   139   113   178   223   153   

bg   58    81    80    69    108   102   97    146   132   
     58    81    80    69    108   102   97    146   132   
     58    81    80    69    108   102   97    146   132   
     58    81    80    69    108   102   97    146   133   

C2   61    85    84    89    154   135   148   270   206   
     61    86    84    89    154   135   148   270   206   
     61    86    84    89    154   135   149   270   206   
     61    86    84    89    154   135   149   271   206   

bg   59    82    81    70    110   103   98    148   134   
     59    82    81    70    110   103   98    148   134   
     59    82    81    70    110   103   98    148   134   
     59    82    81    70    110   103   98    148   134   

C3   60    84    85    73    132   138   104   201   220   
     60    84    85    73    131   138   104   201   219   
     60    84    84    72    131   138   104   201   219   
     60    84    84    72    131   137   103   200   219   

bg   59    81    81    69    109   103   98    147   133   
     59    81    81    69    109   103   98    147   133   
     59    82    81    70    109   103   98    147   133   
     59    82    81    70    110   103   98    148   134   


