Trial #1-------------------------

     A1    A2    A3    B1    B2    B3    C1    C2    C3    

A1   138   158   106   105   147   119   108   160   145   
     138   158   105   105   147   119   108   161   145   
     138   158   105   105   147   119   108   161   145   
     138   158   105   104   147   119   108   161   145   

bg   62    87    87    74    116   111   104   157   143   
     62    87    87    74    116   111   104   157   143   
     63    87    87    74    116   111   104   157   143   
     63    87    87    74    117   111   104   157   143   

A2   109   200   156   94    165   140   107   162   147   
     109   200   156   94    165   140   107   162   147   
     109   200   156   94    164   140   107   162   147   
     109   200   156   94    165   140   107   162   147   

bg   63    87    87    74    117   110   104   158   143   
     63    87    87    74    117   110   104   158   143   
     63    87    87    74    117   110   104   158   143   
     63    87    87    74    117   110   104   158   143   

A3   69    138   170   77    139   140   105   159   146   
     69    138   170   77    139   140   105   159   146   
     69    138   170   77    139   140   105   159   146   
     69    138   170   77    139   140   105   159   145   

bg   62    86    86    73    116   109   103   157   142   
     62    86    86    73    116   109   103   156   141   
     62    86    86    73    116   109   103   156   141   
     62    86    86    73    116   109   103   156   141   

B1   92    116   94    148   183   127   136   187   151   
     92    116   94    148   183   127   136   187   151   
     92    116   94    148   183   127   136   187   151   
     92    116   94    148   183   127   136   187   151   

bg   62    86    86    73    116   110   103   157   142   
     62    86    86    73    116   110   103   157   142   
     62    86    86    73    116   110   103   157   142   
     62    86    87    73    116   110   103   156   142   

B2   83    133   117   117   233   182   123   198   172   
     83    133   117   117   233   182   123   198   172   
     83    133   117   117   233   182   123   198   172   
     83    133   117   117   233   182   123   198   172   

bg   62    86    87    73    116   111   103   156   143   
     62    86    87    73    116   111   103   156   143   
     62    86    87    73    116   111   103   156   143   
     62    86    87    73    116   111   103   156   143   

B3   66    110   120   80    173   197   108   183   182   
     66    110   120   80    173   197   108   183   182   
     66    110   121   80    173   197   108   183   183   
     66    110   121   80    173   198   108   183   183   

bg   62    86    87    73    116   110   103   156   143   
     62    86    86    73    116   110   103   156   143   
     62    86    87    73    116   111   103   156   143   
     62    86    87    73    116   111   103   156   143   

C1   66    90    89    106   147   121   185   233   163   
     66    90    89    106   147   121   185   233   163   
     66    90    89    106   146   121   184   233   163   
     66    90    89    106   146   121   184   233   163   

bg   62    86    87    73    116   111   103   156   143   
     62    86    87    73    116   111   104   157   143   
     62    86    87    74    116   111   104   157   143   
     62    87    87    74    116   111   104   157   143   

C2   65    91    90    93    161   143   154   280   216   
     65    91    90    93    161   143   155   280   216   
     65    91    90    93    161   143   155   280   216   
     65    91    90    93    161   143   155   280   216   

bg   63    87    87    74    117   111   104   157   144   
     63    87    87    74    117   111   104   157   144   
     63    87    87    74    117   111   104   158   144   
     63    87    87    74    117   111   104   158   144   

C3   64    90    91    77    139   146   110   211   229   
     64    90    91    77    139   146   110   211   229   
     64    89    91    77    139   146   110   211   229   
     64    90    91    77    139   146   110   211   229   

bg   63    87    87    74    117   112   104   158   144   
     63    88    88    75    118   113   106   159   146   
     66    92    92    78    123   118   110   166   153   
     66    93    93    79    124   119   110   168   153   


Trial #2-------------------------

     A1    A2    A3    B1    B2    B3    C1    C2    C3    

A1   139   160   107   106   149   122   109   163   148   
     139   159   107   105   149   121   109   162   147   
     139   159   107   105   148   121   109   162   147   
     138   158   106   105   148   121   108   162   146   

bg   62    87    87    74    117   111   104   157   144   
     62    87    87    74    116   111   104   157   143   
     62    87    87    73    116   111   103   157   143   
     62    86    87    73    116   111   103   157   143   

A2   109   200   157   93    164   141   107   162   147   
     109   201   157   94    165   141   107   162   148   
     110   201   157   94    165   142   108   163   149   
     110   201   157   94    165   142   108   163   149   

bg   63    87    88    74    117   112   104   158   144   
     63    87    88    74    117   112   104   158   144   
     63    87    87    74    117   112   104   158   144   
     63    87    88    74    117   112   104   158   144   

A3   69    139   172   77    140   143   105   160   148   
     69    139   172   77    140   143   105   160   148   
     69    139   172   77    140   143   105   160   148   
     69    139   172   77    140   143   105   160   148   

bg   63    87    87    74    117   112   104   158   144   
     63    87    87    74    117   112   104   158   144   
     63    87    87    74    117   112   104   158   144   
     63    87    87    74    117   112   104   158   144   

B1   93    116   96    148   184   129   137   188   153   
     93    117   96    148   184   130   137   189   154   
     93    117   97    149   185   130   138   190   155   
     93    117   96    148   185   130   138   190   155   

bg   63    88    88    74    118   112   105   159   145   
     63    87    88    74    117   112   104   158   145   
     63    87    88    74    117   112   105   159   145   
     63    87    88    74    117   112   105   159   145   

B2   83    134   118   118   234   183   124   200   174   
     83    134   118   118   234   183   124   200   173   
     83    134   118   118   234   183   124   200   173   
     83    134   118   118   234   183   124   200   173   

bg   63    87    87    74    117   111   104   158   144   
     63    87    87    74    117   111   104   158   144   
     63    87    87    74    117   111   104   158   144   
     63    87    87    74    117   111   104   158   144   

B3   66    110   121   80    173   197   108   183   183   
     66    110   121   80    173   197   109   184   183   
     67    111   121   81    174   198   110   185   184   
     68    113   124   83    176   200   112   188   187   

bg   63    88    89    75    119   113   105   160   147   
     63    87    88    74    117   112   104   158   144   
     62    87    87    74    117   111   104   157   144   
     62    87    87    74    116   111   104   157   144   

C1   66    91    89    106   147   122   184   234   164   
     66    91    89    106   147   122   184   234   164   
     66    91    89    106   147   122   184   234   164   
     66    90    89    106   147   122   184   233   164   

bg   62    87    87    73    116   111   103   157   143   
     62    86    87    73    116   111   103   157   143   
     62    87    87    73    116   111   103   157   143   
     62    87    87    73    116   111   104   157   143   

C2   65    91    90    93    161   143   154   279   215   
     65    91    90    93    161   143   154   279   215   
     65    91    90    93    161   143   154   279   215   
     65    91    90    93    161   143   154   279   215   

bg   63    87    87    74    117   111   104   157   144   
     63    87    87    74    117   111   104   157   144   
     63    87    87    74    117   111   104   158   144   
     63    87    87    74    117   111   104   158   144   

C3   64    90    91    77    139   146   110   211   229   
     64    90    91    77    139   146   110   211   229   
     64    90    91    77    139   146   110   211   229   
     64    90    91    77    139   146   110   211   229   

bg   63    87    87    74    117   111   104   158   144   
     63    87    87    74    117   111   104   158   144   
     63    87    87    74    116   111   104   157   144   
     63    87    87    74    116   111   104   157   144   


Trial #3-------------------------

     A1    A2    A3    B1    B2    B3    C1    C2    C3    

A1   138   158   106   105   147   120   108   160   145   
     138   158   106   104   147   120   108   161   145   
     138   158   106   104   147   120   108   161   146   
     137   157   106   104   147   120   108   161   146   

bg   63    87    87    74    117   112   104   158   144   
     63    87    87    74    117   112   104   158   144   
     63    87    87    74    117   112   104   158   145   
     63    87    87    74    117   112   104   158   144   

A2   109   199   156   93    163   140   106   161   147   
     108   199   156   93    163   140   106   161   147   
     108   199   155   93    163   140   106   161   146   
     109   199   156   93    163   140   106   161   147   

bg   63    87    87    74    117   112   104   158   144   
     63    87    88    74    117   112   104   158   144   
     63    87    88    74    117   112   105   158   145   
     63    88    88    74    118   112   105   159   145   

A3   70    139   172   78    141   144   107   162   150   
     70    140   172   78    142   144   107   162   150   
     70    139   172   78    142   144   107   162   150   
     70    139   172   78    141   144   107   162   150   

bg   63    87    87    74    117   112   105   159   144   
     63    87    87    74    117   111   105   158   144   
     63    87    87    74    117   111   104   158   144   
     63    87    87    74    117   111   104   158   144   

B1   93    116   95    148   184   129   137   188   153   
     93    116   95    148   184   129   137   188   153   
     93    116   95    148   184   129   137   188   153   
     93    116   95    148   184   129   137   188   153   

bg   63    87    87    74    117   111   104   158   144   
     63    87    87    74    117   111   104   157   144   
     63    87    87    74    117   111   104   158   144   
     63    87    87    74    117   111   104   158   144   

B2   84    135   118   118   235   184   125   201   174   
     84    135   118   118   235   184   125   201   174   
     84    135   118   118   235   184   125   201   174   
     84    135   118   118   235   183   124   201   174   

bg   63    87    87    74    117   112   105   159   144   
     63    87    87    74    117   111   104   158   144   
     63    87    87    74    117   112   104   158   144   
     63    87    87    74    117   112   104   158   144   

B3   67    111   121   81    174   198   109   184   184   
     67    111   121   81    174   198   109   184   184   
     67    111   121   81    174   198   109   184   184   
     67    111   121   81    174   198   109   184   184   

bg   63    87    88    74    117   112   104   158   145   
     63    87    87    74    117   112   104   158   144   
     63    87    87    74    117   112   104   158   144   
     63    87    87    74    117   112   104   158   144   

C1   66    91    89    106   147   122   185   234   165   
     66    91    89    106   147   122   184   234   165   
     66    91    89    106   147   122   184   234   164   
     66    91    89    106   147   122   184   234   164   

bg   63    87    87    74    117   111   104   158   144   
     63    87    87    74    117   111   104   158   144   
     63    87    87    74    117   111   104   158   144   
     63    87    87    74    117   111   104   158   144   

C2   65    91    90    93    162   143   155   280   216   
     65    91    91    94    162   144   155   280   216   
     65    91    91    94    162   143   155   280   216   
     65    91    91    94    162   143   155   280   216   

bg   63    87    87    74    117   112   104   158   144   
     63    87    87    74    117   112   104   158   144   
     63    87    87    74    117   111   104   158   144   
     63    87    87    74    117   111   104   158   144   

C3   64    90    91    77    139   146   110   211   229   
     64    90    91    77    139   146   110   211   229   
     64    90    91    77    139   146   110   211   229   
     64    90    91    77    139   146   110   211   229   

bg   63    87    87    74    117   111   104   158   144   
     63    87    87    74    117   111   104   158   144   
     63    87    87    74    117   111   104   158   143   
     63    87    87    74    117   111   104   158   143   


Trial #4-------------------------

     A1    A2    A3    B1    B2    B3    C1    C2    C3    

A1   138   158   106   105   148   120   108   161   145   
     138   158   106   105   147   120   108   161   145   
     138   158   106   105   147   120   108   161   145   
     138   158   106   105   147   120   108   161   145   

bg   63    87    87    74    117   111   104   158   144   
     63    87    87    74    117   112   104   158   144   
     63    88    88    74    118   112   105   159   145   
     63    88    88    74    118   112   105   159   145   

A2   110   201   157   94    166   142   108   164   149   
     110   201   157   94    166   142   108   164   149   
     109   200   157   94    165   141   108   163   149   
     109   200   156   94    165   141   107   162   148   

bg   62    87    87    74    117   111   104   157   143   
     62    87    87    74    117   111   104   157   143   
     62    87    87    74    117   111   104   158   144   
     63    87    87    74    117   111   104   158   144   

A3   70    139   172   77    140   143   106   161   148   
     70    139   171   77    140   143   106   161   148   
     70    139   171   77    140   143   106   161   148   
     70    139   171   77    141   143   106   161   149   

bg   63    87    87    74    118   112   105   159   144   
     63    87    88    74    118   112   105   159   144   
     63    88    88    74    118   112   105   159   145   
     63    87    88    74    118   112   105   159   144   

B1   93    116   95    148   184   129   137   188   153   
     93    116   95    148   184   129   137   188   153   
     93    116   95    148   184   129   137   188   153   
     93    116   95    148   184   129   137   188   153   

bg   63    87    87    74    117   111   104   158   144   
     63    87    87    74    117   111   104   158   144   
     63    87    87    74    117   111   104   158   144   
     63    87    87    74    117   111   104   158   144   

B2   83    134   117   118   234   183   124   200   173   
     83    134   117   118   234   183   124   200   173   
     83    134   117   118   234   183   124   200   173   
     83    134   117   118   234   183   124   200   173   

bg   63    87    87    74    117   111   104   158   144   
     63    87    87    74    117   111   104   158   144   
     63    87    87    74    117   111   104   158   144   
     63    87    87    74    117   111   104   158   144   

B3   67    111   121   81    174   198   109   184   183   
     67    111   121   81    174   198   109   184   183   
     67    111   121   81    174   197   109   184   183   
     67    111   121   81    174   197   109   184   183   

bg   63    87    87    74    117   111   104   158   144   
     63    87    87    74    117   111   104   158   144   
     63    87    87    74    117   111   104   158   144   
     63    87    87    74    117   111   104   158   144   

C1   66    91    89    107   148   122   185   235   164   
     66    91    89    107   148   122   185   235   164   
     66    91    89    107   148   122   185   235   164   
     66    91    89    107   148   122   185   235   164   

bg   63    87    87    74    117   111   104   158   144   
     62    87    87    74    117   111   104   157   143   
     62    87    87    74    117   111   104   157   143   
     62    87    87    74    117   111   104   157   143   

C2   65    91    90    93    161   143   155   280   215   
     65    91    90    93    161   143   155   280   215   
     65    91    90    94    161   143   155   280   215   
     65    91    90    94    162   143   155   280   215   

bg   63    87    87    74    117   111   104   158   143   
     62    87    87    74    117   111   104   158   143   
     62    87    87    74    117   111   104   157   143   
     62    87    87    74    117   111   104   157   143   

C3   64    90    91    77    139   146   110   211   229   
     64    90    91    77    139   146   110   211   229   
     64    89    91    77    139   146   110   211   229   
     64    90    91    77    139   146   110   211   229   

bg   62    87    87    74    117   111   104   158   143   
     63    87    87    74    117   111   104   158   144   
     63    87    87    74    117   111   104   158   143   
     63    87    87    74    117   111   104   158   143   


