Trial #1-------------------------

     A1    A2    A3    B1    B2    B3    C1    C2    C3    

A1   132   149   96    97    136   108   98    145   130   
     131   149   96    97    136   108   98    145   130   
     131   149   96    97    136   108   98    145   130   
     131   149   96    97    135   108   98    145   130   

bg   56    78    78    67    105   99    94    142   128   
     57    78    78    67    105   99    94    142   128   
     56    78    78    67    105   99    94    142   128   
     56    78    78    66    105   99    94    141   128   

A2   103   191   147   86    153   128   97    146   132   
     103   192   147   87    153   128   97    146   132   
     103   192   147   87    153   129   97    147   133   
     103   192   148   87    154   129   98    147   133   

bg   57    79    79    67    106   100   95    143   130   
     57    79    79    67    106   100   95    143   129   
     57    79    78    67    106   100   94    143   129   
     57    79    78    67    106   99    94    142   129   

A3   63    130   162   70    129   130   95    145   133   
     63    130   161   70    128   130   95    144   132   
     63    130   161   70    128   130   95    144   132   
     63    129   161   70    128   130   95    144   132   

bg   56    78    78    66    105   98    93    141   128   
     56    78    78    66    105   99    93    141   128   
     56    78    77    66    105   98    93    141   128   
     56    78    77    66    105   99    93    141   128   

B1   86    107   86    140   172   116   126   172   137   
     86    107   86    140   172   116   126   172   137   
     86    107   86    140   172   116   126   172   137   
     86    107   86    140   172   116   126   172   137   

bg   56    78    78    66    105   99    94    141   128   
     56    78    78    66    105   99    94    141   128   
     56    78    78    66    105   99    94    141   128   
     56    78    78    66    105   99    94    142   128   

B2   76    125   107   110   221   169   112   182   156   
     76    124   107   109   221   169   112   182   156   
     76    124   107   110   221   169   112   182   156   
     77    125   107   110   221   169   112   182   156   

bg   56    78    78    66    105   99    94    141   128   
     56    78    78    66    105   99    94    141   128   
     56    78    78    67    105   99    94    142   128   
     57    78    78    67    105   99    94    142   128   

B3   60    102   111   73    162   185   98    168   168   
     60    102   111   73    162   185   98    168   168   
     60    102   111   73    162   185   98    168   168   
     60    102   111   73    162   185   98    168   168   

bg   57    79    78    67    105   99    94    142   128   
     57    78    78    67    105   99    94    142   128   
     57    78    78    67    105   99    94    141   128   
     56    78    78    66    105   99    94    141   128   

C1   60    82    79    99    135   109   174   218   148   
     59    82    79    99    135   109   174   217   148   
     59    81    79    99    135   109   173   217   148   
     59    81    79    98    134   108   173   216   147   

bg   56    77    77    66    103   97    92    140   126   
     56    78    77    66    104   98    93    140   127   
     56    78    77    66    104   98    93    140   127   
     56    78    77    66    104   98    93    140   127   

C2   58    81    80    85    149   129   143   263   199   
     58    82    80    86    149   130   144   263   199   
     58    82    80    86    149   130   144   264   199   
     59    82    80    86    149   130   144   264   200   

bg   56    78    78    66    105   99    94    141   128   
     56    78    78    66    105   99    94    142   128   
     56    78    78    67    105   99    94    142   128   
     56    78    78    66    105   99    94    141   128   

C3   58    81    81    70    127   133   100   194   213   
     58    81    81    70    127   133   100   195   213   
     58    81    81    70    127   133   100   195   213   
     58    81    81    70    127   133   100   195   213   

bg   56    78    78    66    105   99    94    141   128   
     56    78    78    66    105   99    94    141   128   
     56    78    78    66    105   99    94    141   128   
     56    78    78    66    105   99    94    141   128   


Trial #2-------------------------

     A1    A2    A3    B1    B2    B3    C1    C2    C3    

A1   132   150   96    97    136   107   98    145   130   
     132   150   96    97    136   107   98    145   130   
     131   149   96    97    136   107   98    145   130   
     131   149   96    97    136   107   98    145   130   

bg   56    78    78    66    105   99    94    141   128   
     56    78    78    66    105   99    94    141   128   
     56    78    78    66    105   99    94    141   128   
     56    78    78    66    105   99    94    141   128   

A2   103   191   147   86    153   128   97    146   132   
     103   191   147   86    153   128   97    146   132   
     103   191   147   86    153   128   97    146   132   
     103   191   147   86    153   128   97    146   132   

bg   57    79    78    67    106   100   94    143   129   
     57    79    78    67    106   99    94    142   129   
     57    79    79    67    106   100   95    143   130   
     57    79    79    67    106   100   95    143   129   

A3   63    130   162   70    128   130   95    144   132   
     63    130   162   70    128   130   95    144   132   
     63    130   162   70    128   130   95    144   132   
     63    130   161   70    128   130   95    144   132   

bg   56    78    78    66    105   99    94    142   128   
     56    78    78    66    105   99    94    141   128   
     56    78    78    66    105   99    94    141   128   
     56    78    78    66    105   98    93    141   128   

B1   86    107   86    140   172   116   126   171   137   
     86    107   86    140   172   116   126   171   137   
     86    107   86    140   172   116   126   172   137   
     86    107   86    140   172   116   126   172   137   

bg   56    79    78    67    105   99    94    142   128   
     57    78    78    67    105   99    94    142   129   
     56    78    78    66    105   99    94    142   128   
     56    78    78    67    105   99    94    142   128   

B2   77    125   108   110   222   170   113   184   157   
     77    125   107   110   221   170   113   183   157   
     77    125   107   110   221   169   113   183   156   
     77    125   107   110   221   169   113   183   156   

bg   56    78    77    66    104   98    93    140   127   
     56    78    77    66    104   98    93    141   128   
     56    78    77    66    105   98    93    141   128   
     56    78    78    66    105   99    94    141   128   

B3   60    102   111   73    162   185   98    168   168   
     60    102   111   73    162   185   98    168   168   
     60    102   111   73    162   185   98    168   168   
     60    102   111   73    162   185   98    168   168   

bg   56    78    77    66    104   98    93    140   127   
     56    78    77    66    104   98    93    140   127   
     56    78    77    66    104   98    93    141   127   
     56    78    77    66    104   98    93    140   127   

C1   59    82    79    99    135   109   173   217   148   
     59    82    79    99    135   109   173   217   148   
     59    82    79    99    135   109   173   217   148   
     59    82    79    99    135   109   173   217   148   

bg   56    78    78    66    105   99    94    141   128   
     56    78    77    66    105   98    93    141   128   
     56    78    77    66    104   98    93    141   127   
     56    78    77    66    104   98    93    141   127   

C2   58    82    80    86    149   130   144   264   200   
     58    82    80    86    149   130   144   264   200   
     58    82    80    86    149   130   144   264   200   
     58    82    80    86    149   130   144   264   200   

bg   56    78    78    66    105   99    94    141   128   
     56    78    78    66    105   99    94    141   128   
     56    78    78    66    105   99    94    141   128   
     56    78    78    66    105   99    94    141   128   

C3   58    81    81    70    127   133   100   195   213   
     58    81    81    70    127   133   100   195   213   
     58    81    81    70    127   133   100   195   213   
     58    81    81    70    127   133   100   195   213   

bg   56    78    78    66    105   99    94    141   128   
     56    78    78    66    105   99    94    141   128   
     56    78    78    66    105   99    94    141   128   
     56    78    78    66    105   98    93    141   128   


Trial #3-------------------------

     A1    A2    A3    B1    B2    B3    C1    C2    C3    

A1   132   149   96    97    135   107   97    144   129   
     132   149   96    97    135   107   97    144   129   
     131   149   96    97    135   107   97    144   129   
     131   149   96    97    135   108   98    145   130   

bg   57    79    78    67    105   99    94    142   129   
     56    78    77    66    104   98    93    140   127   
     56    77    77    66    104   98    93    140   127   
     56    77    77    66    104   98    92    140   126   

A2   102   190   146   86    152   127   96    144   130   
     102   190   146   86    152   127   96    145   131   
     102   190   146   86    152   127   96    145   131   
     102   190   146   86    152   127   96    145   131   

bg   56    78    77    66    105   98    93    141   128   
     56    78    77    66    104   98    93    141   128   
     56    78    77    66    105   98    93    141   128   
     56    78    77    66    105   98    93    141   128   

A3   63    130   162   70    128   130   95    144   132   
     63    130   162   70    128   130   95    144   132   
     63    130   162   70    128   130   95    144   132   
     63    130   162   70    128   130   95    144   132   

bg   56    78    78    67    105   99    94    141   128   
     56    78    78    67    105   99    94    142   128   
     56    78    78    67    105   99    94    142   128   
     57    79    78    67    105   99    94    142   129   

B1   87    108   86    141   173   117   127   173   138   
     87    108   86    141   173   117   127   173   138   
     87    108   86    141   173   117   127   173   138   
     87    108   86    141   173   117   127   172   138   

bg   56    78    78    66    105   99    94    141   128   
     56    78    78    66    105   99    94    141   128   
     56    78    77    66    105   99    94    141   128   
     56    78    78    66    105   99    94    141   128   

B2   77    125   108   110   222   170   113   184   158   
     77    125   108   110   222   170   113   183   157   
     77    125   107   110   221   170   113   183   157   
     77    125   107   110   221   169   112   182   156   

bg   56    78    77    66    104   98    93    141   127   
     56    78    77    66    104   98    93    141   127   
     56    78    77    66    104   98    93    141   127   
     56    78    77    66    104   98    93    141   127   

B3   60    101   110   72    160   183   97    166   166   
     60    101   110   72    160   183   97    166   166   
     60    101   110   72    161   183   97    166   166   
     60    101   110   72    161   183   97    166   166   

bg   56    78    77    66    105   98    93    141   127   
     56    78    77    66    105   98    93    141   127   
     56    78    77    66    105   98    93    141   127   
     56    78    77    66    105   98    93    141   127   

C1   59    82    79    99    135   109   174   217   148   
     59    82    79    99    135   109   174   217   148   
     59    82    79    99    135   109   174   217   148   
     59    82    79    99    135   109   174   217   148   

bg   56    78    77    66    104   98    93    141   127   
     56    78    77    66    104   98    93    141   127   
     56    78    77    66    104   98    93    141   127   
     56    78    77    66    104   98    93    141   127   

C2   59    82    80    86    149   130   144   264   199   
     59    82    80    86    149   130   144   264   199   
     59    82    80    86    149   130   144   263   199   
     59    82    80    86    149   130   144   264   199   

bg   56    78    77    66    104   98    93    141   127   
     56    78    77    66    104   98    93    141   127   
     56    78    77    66    104   98    93    141   127   
     56    78    77    66    105   98    93    141   127   

C3   58    81    81    69    127   133   100   195   213   
     58    81    81    69    127   133   100   195   213   
     58    81    81    69    127   133   100   195   213   
     58    81    81    69    127   133   100   195   213   

bg   56    78    77    66    105   98    93    141   127   
     56    78    77    66    104   98    93    141   127   
     56    78    77    66    105   98    93    141   127   
     56    78    77    66    104   98    93    141   127   


Trial #4-------------------------

     A1    A2    A3    B1    B2    B3    C1    C2    C3    

A1   132   150   96    97    135   107   97    144   129   
     132   150   96    97    135   107   97    144   130   
     132   149   96    97    135   107   98    144   130   
     131   149   96    97    135   107   97    144   130   

bg   56    78    77    66    105   98    93    141   128   
     56    78    77    66    105   98    93    141   128   
     56    78    77    66    105   98    93    141   127   
     56    78    77    66    104   98    93    141   127   

A2   103   191   147   86    152   127   96    145   131   
     103   191   146   86    152   128   96    145   131   
     103   191   147   86    152   128   96    145   131   
     103   191   146   86    152   128   96    145   131   

bg   56    78    77    66    104   98    93    141   127   
     56    78    77    66    104   98    93    141   127   
     56    78    77    66    104   98    93    140   127   
     56    78    77    66    104   98    93    140   127   

A3   63    130   162   70    128   130   95    144   132   
     63    130   162   70    128   130   95    144   132   
     63    130   162   70    128   130   95    144   132   
     63    130   161   70    128   130   95    144   132   

bg   56    78    78    67    105   99    94    142   128   
     56    78    78    66    105   99    94    141   128   
     56    78    78    66    105   99    94    141   128   
     56    78    78    66    105   99    94    141   128   

B1   86    107   85    140   171   116   126   171   136   
     86    107   85    140   171   116   126   171   136   
     86    107   85    140   171   115   126   171   136   
     86    107   85    140   171   115   126   171   136   

bg   56    78    77    66    104   98    93    141   127   
     56    78    77    66    104   98    93    141   127   
     56    78    77    66    105   98    93    141   127   
     56    78    77    66    105   98    93    141   128   

B2   77    125   107   110   221   170   113   183   157   
     77    125   108   110   221   170   113   184   157   
     77    125   108   110   221   170   113   184   157   
     77    125   108   110   221   170   113   183   157   

bg   57    79    78    67    105   99    94    142   128   
     57    79    78    67    106   99    94    142   129   
     57    79    78    67    106   99    94    142   129   
     57    79    78    67    106   99    94    142   129   

B3   60    102   111   73    162   185   98    168   167   
     60    102   111   73    161   185   98    168   167   
     60    102   111   73    161   184   98    167   167   
     60    102   111   73    162   184   98    168   167   

bg   56    78    77    66    104   98    93    141   127   
     56    78    77    66    104   98    93    140   127   
     56    78    77    66    104   98    93    140   126   
     56    78    77    66    104   98    93    140   127   

C1   60    82    79    99    135   109   174   217   148   
     60    82    79    99    135   109   174   217   148   
     60    82    80    99    135   109   174   218   148   
     60    82    80    99    135   109   174   218   148   

bg   56    78    78    66    105   99    94    141   128   
     56    78    77    66    105   98    93    141   127   
     56    78    77    66    104   98    93    141   127   
     56    78    77    66    104   98    93    141   127   

C2   59    82    80    86    150   130   144   264   200   
     59    82    81    86    150   130   145   264   200   
     59    82    81    86    150   131   145   264   200   
     59    82    81    86    150   131   145   264   200   

bg   56    78    78    67    105   99    94    142   128   
     56    78    78    67    105   99    94    142   128   
     56    78    78    67    105   99    94    142   128   
     56    78    78    67    105   99    94    142   128   

C3   58    81    81    70    127   133   100   195   213   
     58    81    81    70    127   133   100   195   213   
     58    81    81    70    127   133   100   195   213   
     58    81    81    70    127   133   100   195   213   

bg   56    78    77    66    105   98    94    141   128   
     56    78    77    66    104   98    93    141   127   
     56    78    77    66    104   98    93    141   127   
     56    78    77    66    104   98    93    141   127   


