Trial #1-------------------------

     A1    A2    A3    B1    B2    B3    C1    C2    C3    

A1   140   161   109   107   151   124   110   166   151   
     140   161   109   107   151   123   111   166   150   
     140   161   109   107   151   123   111   166   150   
     141   161   109   107   151   123   111   166   150   

bg   65    90    90    76    120   114   107   162   147   
     65    90    90    76    120   114   107   162   147   
     65    90    90    76    120   114   107   162   148   
     65    90    90    76    120   114   107   162   148   

A2   112   203   161   96    169   145   110   168   153   
     112   204   161   97    170   146   111   169   155   
     113   204   162   97    171   147   112   170   156   
     113   205   162   97    171   147   112   170   156   

bg   66    91    91    77    121   115   108   164   149   
     66    90    91    77    121   115   108   163   148   
     66    90    90    77    120   114   107   163   148   
     65    90    90    77    120   114   107   162   147   

A3   72    141   175   79    144   146   108   165   152   
     72    141   175   79    144   146   108   165   153   
     72    141   176   79    144   147   108   165   153   
     72    142   176   80    144   147   108   167   154   

bg   65    90    91    76    121   115   107   163   150   
     65    90    90    76    120   115   107   162   148   
     65    90    90    76    120   114   107   162   147   
     65    90    90    76    120   114   107   162   147   

B1   96    119   98    152   188   132   141   193   156   
     96    119   98    151   188   132   140   193   157   
     96    119   99    151   187   132   140   193   157   
     95    119   99    150   187   132   140   193   157   

bg   65    90    91    76    120   115   107   162   149   
     65    90    90    76    120   115   106   162   149   
     65    90    90    76    120   115   106   162   149   
     65    90    90    76    120   115   107   162   148   

B2   86    137   120   120   237   186   127   204   177   
     86    137   120   120   237   185   127   204   176   
     86    137   120   120   237   185   127   204   176   
     86    137   120   120   237   185   127   204   176   

bg   65    90    90    76    120   115   107   162   148   
     65    90    90    76    120   115   107   162   148   
     65    90    90    76    120   115   107   162   148   
     65    90    90    76    120   115   107   162   149   

B3   69    114   124   83    177   202   111   188   188   
     69    114   124   83    177   201   111   188   188   
     69    114   124   83    177   201   112   188   187   
     70    114   124   83    177   200   112   189   187   

bg   66    90    90    77    120   114   108   163   148   
     66    90    90    77    120   114   107   163   148   
     65    90    90    77    120   115   107   162   148   
     65    90    90    76    120   115   107   162   148   

C1   68    93    92    108   150   125   186   238   168   
     68    93    92    108   150   125   186   237   168   
     68    93    92    108   150   125   186   237   168   
     69    93    92    108   150   125   186   237   168   

bg   65    90    90    76    120   114   107   162   147   
     65    90    90    77    120   114   107   162   147   
     66    90    90    77    120   114   107   162   147   
     66    90    90    77    120   114   108   162   147   

C2   68    94    94    96    165   147   158   285   220   
     68    94    94    96    165   147   158   285   221   
     68    94    94    96    165   147   158   285   221   
     68    95    94    96    166   148   158   285   221   

bg   67    92    93    79    124   118   110   167   152   
     68    94    94    80    125   119   112   169   154   
     68    94    94    80    125   119   112   169   154   
     67    93    93    79    124   118   111   168   152   

C3   68    93    94    81    144   150   115   217   233   
     67    93    94    80    143   150   114   217   233   
     67    93    94    80    143   150   114   216   234   
     67    93    94    80    143   150   113   216   234   

bg   65    90    91    76    120   115   107   162   149   
     65    90    90    76    120   115   107   162   148   
     65    90    90    76    120   114   106   162   148   
     65    90    90    76    120   114   106   161   147   


Trial #2-------------------------

     A1    A2    A3    B1    B2    B3    C1    C2    C3    

A1   142   161   109   108   151   123   111   165   149   
     142   161   109   108   151   123   112   166   149   
     142   161   109   108   151   123   112   166   149   
     142   161   109   108   151   123   112   166   150   

bg   66    90    91    77    121   115   107   163   149   
     66    90    91    77    121   115   107   163   149   
     65    90    91    76    121   115   107   163   149   
     66    91    91    77    121   116   108   164   150   

A2   112   203   160   97    169   145   111   168   153   
     112   203   160   97    168   144   110   167   152   
     112   203   159   97    168   144   110   167   152   
     112   203   159   97    168   144   111   167   151   

bg   66    90    90    77    120   114   108   163   148   
     66    90    90    77    120   114   107   162   148   
     66    90    90    77    120   115   107   162   148   
     65    90    90    76    120   115   107   162   148   

A3   72    141   176   79    143   147   108   165   153   
     72    141   175   79    143   146   108   165   153   
     72    141   175   80    143   146   108   165   153   
     72    141   174   80    143   146   108   165   152   

bg   65    90    90    76    120   114   107   162   147   
     65    90    90    76    120   114   107   162   147   
     65    90    90    76    120   114   107   162   147   
     65    90    90    76    120   114   107   162   147   

B1   96    119   98    150   187   132   140   192   157   
     95    119   98    150   187   132   139   192   157   
     95    119   98    149   187   132   139   192   157   
     95    119   99    149   187   132   139   192   157   

bg   66    90    91    77    121   115   107   163   149   
     66    90    90    77    120   115   107   163   148   
     66    90    90    77    120   115   107   163   148   
     66    90    90    77    121   115   108   163   148   

B2   86    137   120   121   237   186   127   205   177   
     86    137   121   120   237   186   127   205   177   
     86    137   121   120   237   186   127   205   177   
     86    137   121   120   237   186   126   205   178   

bg   65    90    90    76    120   115   107   162   149   
     65    90    90    76    120   115   107   162   149   
     65    90    90    76    120   115   107   162   148   
     65    90    90    76    120   115   107   162   148   

B3   69    113   123   83    177   200   112   188   187   
     70    113   123   83    177   200   112   188   187   
     70    114   123   83    177   200   112   188   187   
     70    114   123   83    177   199   112   188   187   

bg   65    90    90    76    120   115   107   162   148   
     65    90    91    76    120   115   107   163   149   
     65    90    91    76    120   115   107   163   149   
     65    90    91    76    120   115   107   163   149   

C1   69    93    92    109   151   125   187   238   168   
     69    93    92    109   150   125   187   238   168   
     69    93    92    109   150   124   187   238   167   
     69    93    91    109   150   124   187   237   167   

bg   65    89    89    76    119   113   106   161   146   
     65    89    90    76    119   114   106   161   147   
     65    89    90    76    119   114   106   161   147   
     65    89    90    76    120   114   106   161   147   

C2   67    93    93    95    164   146   156   284   219   
     67    93    93    95    164   146   156   284   219   
     67    94    93    96    164   146   157   284   220   
     68    94    93    96    165   146   157   284   219   

bg   66    90    90    77    120   114   107   162   148   
     66    90    90    77    120   114   108   162   148   
     66    90    90    77    120   114   108   162   148   
     66    90    90    77    120   114   107   162   148   

C3   67    92    94    79    143   150   113   216   234   
     67    92    94    79    142   150   113   216   235   
     67    92    94    79    142   150   113   216   235   
     66    92    94    79    142   150   113   216   234   

bg   65    90    90    76    120   114   107   162   148   
     65    90    90    76    120   114   107   162   148   
     66    90    90    77    120   114   107   162   148   
     66    90    90    77    120   114   107   162   148   


Trial #3-------------------------

     A1    A2    A3    B1    B2    B3    C1    C2    C3    

A1   141   161   109   108   151   123   112   166   150   
     141   161   109   107   151   123   111   166   150   
     141   161   109   107   151   123   111   166   150   
     140   160   109   107   151   124   111   166   151   

bg   65    90    91    76    121   115   107   163   149   
     65    90    91    76    120   115   107   163   149   
     71    97    94    80    126   120   117   173   159   
     78    107   106   91    140   134   127   191   175   

A2   112   203   160   97    169   144   110   167   152   
     112   203   159   96    167   143   110   166   150   
     112   202   159   96    168   143   110   166   151   
     112   202   159   96    168   143   110   166   151   

bg   65    90    90    76    120   115   107   162   148   
     65    90    90    76    120   115   107   162   148   
     65    90    90    76    120   115   107   162   148   
     65    90    90    76    120   115   107   162   148   

A3   73    142   175   80    144   146   109   165   153   
     73    142   174   80    144   146   109   165   152   
     73    142   174   80    144   146   109   165   152   
     73    142   174   80    144   146   109   165   152   

bg   66    90    90    77    121   115   108   163   148   
     66    90    90    77    121   115   107   163   148   
     65    90    90    76    120   115   107   162   148   
     65    90    90    76    120   115   107   162   148   

B1   95    119   99    150   188   133   140   193   158   
     95    119   99    150   188   133   140   193   158   
     96    119   99    151   188   133   140   193   157   
     96    119   99    151   188   132   140   193   157   

bg   66    90    90    77    120   114   107   162   148   
     66    90    90    77    120   114   107   162   148   
     66    90    90    77    120   114   107   162   148   
     66    90    90    77    120   115   107   162   148   

B2   86    137   121   120   238   187   127   205   178   
     87    138   122   121   238   187   127   206   179   
     87    138   121   120   238   187   127   206   179   
     87    138   122   121   238   187   127   206   179   

bg   66    91    91    77    121   116   108   164   149   
     66    90    91    77    121   115   108   163   148   
     66    90    90    77    121   115   108   163   148   
     66    90    90    77    120   114   108   163   148   

B3   69    113   124   83    177   200   112   188   187   
     69    113   124   83    177   200   111   188   187   
     69    113   124   83    177   201   111   188   187   
     69    113   124   83    177   201   111   188   187   

bg   65    89    90    76    119   114   106   161   147   
     65    89    90    76    119   114   106   161   147   
     65    89    90    76    120   114   107   162   148   
     65    90    90    76    120   114   107   162   148   

C1   69    94    92    110   151   125   189   239   168   
     69    94    92    110   151   125   189   239   168   
     69    94    92    110   151   125   189   239   169   
     69    94    92    110   151   125   188   239   169   

bg   65    90    91    76    121   115   107   163   149   
     65    90    90    76    120   115   107   162   148   
     65    90    90    76    120   115   107   162   148   
     65    90    90    76    120   115   107   162   148   

C2   68    94    93    96    165   147   158   285   220   
     68    94    93    97    165   147   158   285   220   
     68    94    93    97    165   147   158   285   220   
     68    94    94    97    165   147   158   285   220   

bg   66    90    91    77    121   115   108   163   148   
     66    90    91    77    121   115   108   163   149   
     66    90    91    77    121   115   107   163   149   
     66    90    91    77    121   115   107   163   149   

C3   67    93    94    80    143   150   113   216   234   
     67    93    94    80    143   150   113   216   234   
     67    93    94    80    143   150   113   216   234   
     67    93    94    80    143   150   114   216   233   

bg   66    90    91    77    121   115   108   163   148   
     66    90    90    77    121   115   108   163   148   
     66    90    91    77    121   115   108   163   148   
     66    91    91    77    121   115   108   163   149   


Trial #4-------------------------

     A1    A2    A3    B1    B2    B3    C1    C2    C3    

A1   141   162   110   107   152   124   112   167   152   
     141   161   110   107   151   124   111   166   151   
     140   161   109   107   151   124   111   166   151   
     140   160   109   107   151   124   111   166   151   

bg   66    90    91    77    121   115   107   163   149   
     66    90    91    77    121   115   108   163   149   
     66    90    91    77    121   115   108   163   149   
     66    90    91    77    121   115   108   163   148   

A2   112   204   160   97    169   144   110   167   152   
     112   203   160   97    169   145   110   167   152   
     112   203   160   96    169   145   110   167   153   
     112   203   160   96    169   145   110   167   153   

bg   65    90    91    76    121   115   107   163   149   
     65    90    91    77    121   115   107   163   149   
     66    90    91    77    121   115   107   163   149   
     66    90    91    77    121   115   108   163   149   

A3   73    142   175   80    144   146   109   166   153   
     73    142   174   80    144   146   109   166   153   
     73    142   175   80    144   146   109   166   153   
     73    142   175   80    144   146   109   165   153   

bg   65    90    91    76    121   115   107   163   149   
     65    90    91    76    121   115   107   163   149   
     65    90    91    76    120   115   107   162   149   
     65    90    91    76    120   115   107   162   149   

B1   96    120   99    152   188   132   140   193   157   
     96    120   99    152   188   132   141   193   157   
     96    120   99    152   188   132   141   193   157   
     96    120   99    152   188   133   141   193   157   

bg   66    90    91    77    121   115   108   163   149   
     66    90    91    77    121   115   107   163   149   
     65    90    90    76    120   115   107   162   148   
     65    90    91    76    120   115   107   162   149   

B2   86    137   120   120   237   186   126   204   177   
     86    137   121   120   237   186   126   204   177   
     86    137   121   120   237   186   127   204   177   
     86    137   121   120   237   186   127   205   177   

bg   66    90    91    77    121   115   108   163   149   
     66    90    91    77    121   115   108   163   149   
     66    91    91    77    121   115   108   164   149   
     66    91    91    77    121   115   108   164   149   

B3   70    114   125   84    178   203   112   190   190   
     70    114   125   84    178   203   112   190   190   
     70    114   125   83    178   202   112   190   190   
     70    114   125   83    178   202   112   190   189   

bg   66    90    91    77    120   115   107   163   148   
     66    90    90    77    120   115   107   162   148   
     66    90    90    77    120   115   107   163   148   
     66    90    90    77    120   115   107   162   148   

C1   69    94    92    109   151   126   188   239   169   
     69    94    92    109   151   126   188   239   169   
     69    94    92    109   151   126   187   239   169   
     69    94    92    109   151   126   186   238   169   

bg   65    90    90    76    120   115   107   162   148   
     65    90    90    76    120   115   107   162   148   
     65    90    90    76    120   115   107   162   148   
     66    90    90    77    120   115   107   162   148   

C2   68    94    93    97    165   147   158   285   220   
     68    94    93    97    165   147   158   285   220   
     68    94    94    97    166   147   158   285   220   
     68    94    94    96    166   147   158   285   221   

bg   66    90    91    77    121   115   107   163   149   
     66    90    91    77    121   115   107   163   149   
     66    90    91    77    121   115   107   163   149   
     66    90    91    77    121   115   107   163   149   

C3   67    93    94    80    143   150   114   217   234   
     67    93    94    80    143   150   114   217   234   
     67    93    94    80    143   150   114   217   233   
     67    93    94    80    143   150   114   217   233   

bg   66    90    91    77    121   115   108   163   149   
     66    90    91    77    121   115   107   163   149   
     66    90    91    77    121   115   107   163   149   
     66    90    91    76    121   115   107   163   149   


