     A1    A2    A3    B1    B2    B3    C1    C2    C3    

A1   387   529   369   371   547   388   346   467   344   
     387   529   369   371   547   389   346   467   344   
     387   529   369   371   548   389   346   468   345   
     387   529   369   371   548   389   346   468   345   

bg   319   471   356   346   526   384   343   466   344   
     319   471   357   346   526   384   343   466   344   
     319   471   357   346   526   384   343   466   344   
     319   471   357   346   526   384   343   466   344   

A2   363   583   426   365   572   413   348   472   348   
     363   583   426   365   572   413   348   472   349   
     363   583   427   365   572   413   348   473   349   
     363   583   427   365   572   413   348   473   349   

bg   321   474   359   348   529   386   345   469   346   
     321   474   359   349   530   386   345   469   346   
     321   474   359   349   530   387   346   469   346   
     322   475   360   349   530   387   346   470   347   

A3   329   530   441   353   556   420   348   474   352   
     329   529   440   353   556   419   348   474   352   
     329   530   441   354   556   420   348   474   352   
     330   530   441   354   556   420   348   474   352   

bg   323   477   362   350   533   389   347   472   348   
     323   477   362   350   533   389   348   472   348   
     323   478   362   351   533   389   348   472   349   
     324   478   362   351   533   389   348   473   349   

B1   355   506   370   425   599   406   383   503   357   
     355   506   370   425   599   406   383   503   357   
     355   506   370   425   599   406   383   503   358   
     355   506   370   425   599   407   383   503   358   

bg   325   480   364   352   536   391   349   475   350   
     325   480   364   352   536   391   349   475   350   
     325   480   364   352   536   391   349   475   350   
     325   480   364   353   536   391   349   475   350   

B2   344   523   392   393   647   459   371   518   378   
     344   523   392   393   647   459   371   518   378   
     344   523   392   393   647   459   371   518   378   
     344   523   392   393   647   459   371   518   378   

bg   327   482   365   354   538   393   351   477   352   
     327   482   366   354   538   393   351   477   352   
     327   482   365   354   538   393   351   477   352   
     327   483   366   354   538   393   351   477   352   

B3   330   502   393   359   588   469   356   501   386   
     330   502   394   359   589   470   356   501   386   
     330   502   394   359   589   470   356   501   386   
     330   502   394   359   589   470   356   501   386   

bg   328   484   367   355   540   394   352   478   353   
     328   484   367   355   540   394   352   478   353   
     328   484   367   355   540   394   352   478   353   
     328   484   367   355   540   394   352   478   353   

C1   332   488   369   389   573   406   433   550   375   
     332   488   369   389   573   406   433   550   375   
     332   488   369   389   573   406   432   550   375   
     332   488   369   389   573   406   433   550   375   

bg   329   485   368   356   541   395   353   479   354   
     329   485   368   356   541   395   353   479   354   
     329   485   368   356   541   395   353   479   354   
     329   486   368   356   541   395   353   480   354   

C2   332   490   371   378   591   428   406   590   422   
     332   490   372   378   590   428   406   590   422   
     332   490   371   378   591   428   406   590   422   
     332   490   372   378   590   428   406   589   421   

bg   329   486   369   357   542   396   353   480   355   
     329   486   369   357   542   396   353   480   355   
     329   486   369   357   542   396   354   480   355   
     329   486   369   357   542   396   354   480   355   

C3   331   489   372   360   565   428   362   530   427   
     331   489   372   360   565   428   362   530   427   
     331   489   372   360   566   428   362   530   427   
     331   489   372   360   565   428   362   530   428   

bg   330   487   370   357   543   397   354   481   355   
     330   487   369   357   543   397   354   481   356   
     330   487   369   357   543   397   354   481   356   
     330   487   370   357   543   397   354   481   356   
