     A1    A2    A3    B1    B2    B3    C1    C2    C3    

A1   320   430   293   299   438   308   276   373   275   
     320   430   293   299   438   309   277   373   275   
     321   430   294   299   439   309   277   374   276   
     321   431   294   300   439   310   277   374   276   

bg   254   375   283   276   420   306   276   375   277   
     255   375   284   277   420   307   276   376   277   
     255   376   284   277   421   307   277   376   278   
     255   376   284   277   421   307   277   377   278   

A2   301   490   356   298   469   339   283   385   284   
     301   491   356   298   470   339   284   385   285   
     301   491   356   299   471   340   284   386   285   
     302   492   357   299   471   340   285   386   285   

bg   262   386   292   284   432   315   284   386   285   
     262   386   292   285   433   316   285   387   285   
     263   387   292   285   433   316   285   387   286   
     263   387   293   285   434   316   285   387   286   

A3   273   445   376   292   463   352   290   395   293   
     273   445   376   293   464   352   290   395   294   
     273   445   376   293   464   352   290   395   294   
     274   446   377   294   465   353   291   396   294   

bg   269   397   300   292   444   324   292   397   293   
     269   397   300   293   445   324   292   397   293   
     270   398   301   293   445   325   293   397   293   
     270   398   301   294   446   325   293   398   294   

B1   304   429   311   370   515   345   330   431   305   
     304   430   311   370   515   345   331   432   305   
     304   430   312   371   516   345   331   432   305   
     305   431   312   371   516   346   331   433   306   

bg   276   407   308   300   456   333   300   407   301   
     277   408   308   301   457   333   300   408   301   
     277   408   309   301   457   334   300   408   301   
     277   409   309   301   458   334   301   408   301   

B2   298   454   339   344   572   404   324   454   331   
     298   454   339   344   572   404   324   454   331   
     298   454   339   344   572   404   324   455   332   
     299   455   340   344   572   405   325   455   332   

bg   283   417   315   307   467   341   307   416   307   
     283   417   316   308   467   341   307   417   308   
     284   418   316   308   468   341   307   417   308   
     284   418   316   308   468   341   307   417   308   

B3   289   440   346   315   521   420   314   444   344   
     289   440   346   316   522   420   314   444   344   
     289   441   347   316   522   421   314   445   344   
     289   441   347   316   523   421   315   445   345   

bg   289   426   322   314   476   347   313   424   313   
     289   426   322   314   477   348   313   425   314   
     289   426   323   314   477   348   313   425   314   
     290   427   323   314   478   348   313   425   314   

C1   295   433   327   350   513   362   395   499   338   
     296   434   327   350   514   362   395   499   338   
     296   434   327   350   514   363   396   500   338   
     296   434   328   351   515   363   396   500   339   

bg   294   433   328   320   485   354   318   432   319   
     295   434   328   320   486   354   318   432   319   
     295   434   329   320   486   354   319   433   319   
     295   435   329   320   486   355   319   433   319   

C2   299   442   334   344   538   389   373   546   389   
     300   442   334   344   539   390   373   546   389   
     300   442   335   344   539   390   373   546   389   
     300   443   335   344   539   390   374   546   389   

bg   299   441   334   325   493   360   323   439   324   
     299   441   334   325   494   360   323   439   324   
     300   442   334   325   494   360   324   439   324   
     300   442   334   325   494   361   324   440   324   

C3   303   447   339   331   520   394   333   491   398   
     303   447   339   331   520   394   334   492   399   
     303   448   340   331   521   394   334   492   399   
     303   448   340   331   521   395   334   492   399   

bg   304   448   339   330   501   365   328   445   328   
     304   448   339   330   501   365   328   445   329   
     304   448   339   330   501   366   328   446   329   
     304   449   340   330   502   366   329   446   329   
