     A1    A2    A3    B1    B2    B3    C1    C2    C3    

A1   392   543   386   382   569   408   361   489   362   
     392   543   386   382   569   408   361   489   363   
     391   542   386   382   569   408   361   489   362   
     391   543   386   382   569   408   361   489   362   

bg   332   491   374   360   548   402   358   487   361   
     332   492   374   360   548   402   358   487   361   
     332   492   374   360   548   402   358   487   361   
     332   491   374   360   548   402   358   487   361   

A2   375   602   443   378   592   430   361   491   364   
     375   602   443   378   592   430   361   491   364   
     375   602   443   378   592   430   361   491   364   
     375   602   443   378   592   430   361   491   364   

bg   332   492   374   360   548   402   358   487   361   
     332   492   374   360   549   402   358   487   361   
     332   492   374   360   549   402   358   487   361   
     332   492   374   360   548   402   358   487   361   

A3   340   545   454   364   573   434   359   490   365   
     340   545   454   364   573   434   359   490   365   
     339   545   454   364   573   434   360   490   365   
     339   545   454   364   573   434   360   490   365   

bg   333   492   374   360   548   403   358   487   361   
     332   492   374   360   548   402   358   487   361   
     332   492   374   360   549   402   358   487   361   
     332   492   374   360   548   402   358   487   361   

B1   363   519   381   434   613   419   393   517   369   
     363   519   381   434   613   419   393   517   369   
     363   519   381   434   613   419   393   517   369   
     363   519   381   434   613   419   393   517   369   

bg   332   492   374   360   549   403   358   487   361   
     333   492   374   360   549   403   358   487   361   
     333   492   374   360   549   403   358   487   361   
     333   492   374   360   549   403   358   487   361   

B2   350   533   401   400   659   470   379   530   389   
     350   533   401   400   659   470   379   530   389   
     350   533   401   400   659   469   379   529   389   
     350   533   401   400   658   469   379   529   388   

bg   333   492   374   361   549   403   358   487   361   
     333   492   374   360   549   403   358   487   362   
     333   492   374   361   549   403   358   487   362   
     333   492   374   360   549   403   358   487   362   

B3   335   511   402   365   599   479   362   511   395   
     335   511   402   365   599   479   363   511   395   
     335   511   402   365   599   479   362   511   395   
     335   511   402   365   599   479   362   511   395   

bg   333   492   375   361   549   403   358   487   362   
     333   492   374   360   549   403   358   487   362   
     333   492   374   361   549   403   358   487   362   
     333   492   375   360   549   403   358   487   362   

C1   336   496   376   394   582   414   438   559   383   
     336   496   376   394   582   414   438   559   383   
     336   496   376   394   581   414   438   558   383   
     336   496   376   394   582   414   438   558   383   

bg   333   492   374   360   549   403   358   487   362   
     333   492   374   361   549   403   358   488   361   
     333   492   374   360   549   403   358   487   362   
     333   492   375   361   549   403   358   487   362   

C2   336   497   378   382   598   436   411   598   429   
     335   496   378   382   598   436   411   598   429   
     336   496   378   382   598   436   411   597   429   
     335   497   378   382   598   436   411   597   429   

bg   333   492   375   361   549   403   358   487   362   
     333   492   375   361   549   403   358   488   362   
     333   492   375   360   549   403   358   487   362   
     333   492   375   361   549   403   358   487   362   

C3   334   495   378   364   572   434   366   537   434   
     334   495   378   364   572   434   366   537   434   
     334   495   378   364   572   434   366   537   434   
     334   495   378   364   572   435   366   537   434   

bg   333   492   375   361   549   403   358   488   362   
     333   492   375   361   549   403   358   488   362   
     333   492   375   361   549   403   358   488   362   
     333   492   375   361   549   403   358   488   362   
