     A1    A2    A3    B1    B2    B3    C1    C2    C3    

A1   391   545   391   385   575   413   365   495   367   
     391   545   390   385   575   413   365   495   367   
     391   545   391   384   575   413   365   495   367   
     391   545   390   384   575   413   365   495   367   

bg   337   498   379   365   555   408   362   492   365   
     337   498   379   365   555   408   362   492   365   
     337   498   379   365   556   408   362   492   365   
     337   498   379   364   555   408   362   492   365   

A2   380   609   448   383   599   436   365   497   369   
     380   609   448   382   600   436   365   497   369   
     380   609   448   383   600   436   365   497   369   
     380   609   448   383   600   436   365   497   369   

bg   337   498   379   365   556   408   362   492   365   
     337   498   379   365   556   408   362   493   365   
     337   498   379   365   556   408   362   493   366   
     337   498   379   365   556   408   362   493   366   

A3   344   552   460   369   581   440   364   496   370   
     344   552   460   369   581   440   364   496   370   
     344   552   460   369   581   440   364   496   370   
     344   552   460   369   581   440   364   496   370   

bg   337   499   379   365   556   408   362   493   366   
     337   499   379   365   556   408   362   493   366   
     337   499   380   365   556   408   362   493   366   
     337   499   380   365   556   408   362   493   366   

B1   368   526   387   439   621   425   397   523   374   
     368   526   387   439   621   425   397   523   374   
     368   526   387   439   621   425   397   523   374   
     368   526   387   439   621   425   397   523   374   

bg   337   499   380   365   557   408   362   493   366   
     338   499   380   365   557   408   362   493   366   
     337   499   380   365   556   408   362   493   366   
     337   499   380   365   557   408   362   493   366   

B2   355   540   407   405   667   476   383   536   393   
     355   540   407   405   667   476   383   536   393   
     355   540   407   405   667   476   383   536   393   
     355   540   407   405   666   475   383   535   393   

bg   337   499   380   365   556   409   362   493   366   
     338   499   380   365   557   409   362   493   366   
     338   499   380   365   556   409   362   493   366   
     338   499   380   365   557   409   362   493   366   

B3   340   517   407   370   606   485   367   517   400   
     340   517   407   370   606   485   367   517   400   
     340   518   407   370   606   485   366   517   400   
     340   517   407   370   606   485   366   517   400   

bg   337   499   380   365   556   409   362   493   366   
     337   499   380   365   556   408   362   493   366   
     338   499   380   365   557   408   362   493   366   
     338   499   380   365   556   408   362   493   366   

C1   341   502   382   398   589   420   443   564   388   
     341   502   382   398   589   420   442   564   388   
     341   502   382   398   589   420   441   563   387   
     341   502   382   398   589   420   441   563   387   

bg   338   499   380   365   557   409   362   493   366   
     338   499   380   365   557   409   362   493   366   
     338   499   380   365   557   409   362   493   366   
     338   499   380   365   557   409   362   493   366   

C2   340   504   383   387   606   442   415   604   434   
     341   504   383   387   606   441   415   604   434   
     341   504   383   387   606   441   415   603   434   
     341   504   383   387   606   442   415   603   433   

bg   338   499   380   366   557   409   363   494   366   
     338   499   380   366   557   409   363   494   366   
     338   499   380   366   557   409   363   494   366   
     338   499   380   366   557   409   363   494   366   

C3   339   502   383   369   580   440   371   543   439   
     339   502   383   369   580   441   370   543   439   
     339   502   384   369   580   441   370   543   439   
     339   502   383   369   580   441   371   543   439   

bg   338   500   380   366   557   409   363   494   366   
     338   499   380   366   557   409   363   494   366   
     338   500   380   366   557   409   363   494   366   
     338   500   380   366   557   409   363   494   366   
