     A1    A2    A3    B1    B2    B3    C1    C2    C3    

A1   71    64    17    29    28    8     5     4     2     
     71    64    17    29    28    8     5     4     2     
     70    63    17    29    28    8     5     4     2     
     70    63    17    29    28    8     5     4     2     

bg   0     0     0     0     0     0     0     0     0     
     0     0     0     0     0     0     0     0     0     
     0     0     0     0     0     0     0     0     0     
     0     0     0     0     0     0     0     0     0     

A2   44    110   69    18    44    28    3     5     3     
     44    111   69    18    44    28    3     5     3     
     44    110   69    18    44    28    3     5     3     
     44    110   68    18    44    28    3     5     3     

bg   0     0     0     0     0     0     0     0     0     
     0     0     0     0     0     0     0     0     0     
     0     0     0     0     0     0     0     0     0     
     0     0     0     0     0     0     0     0     0     

A3   8     54    80    4     25    32    2     3     4     
     8     54    80    4     25    32    2     3     4     
     8     54    80    4     25    32    2     3     4     
     8     54    80    4     25    32    2     3     4     

bg   0     0     0     0     0     0     0     0     0     
     0     0     0     0     0     0     0     0     0     
     0     0     0     0     0     0     0     0     0     
     0     0     0     0     0     0     0     0     0     

B1   32    27    7     74    65    17    35    30    8     
     32    27    7     74    65    17    35    30    8     
     32    27    7     74    64    17    35    30    8     
     32    27    7     74    64    17    35    30    8     

bg   0     0     0     0     0     0     0     0     0     
     0     0     0     0     0     0     0     0     0     
     0     0     0     0     0     0     0     0     0     
     0     0     0     0     0     0     0     0     0     

B2   19    42    27    40    110   67    21    42    27    
     19    42    27    40    110   67    21    42    27    
     19    41    27    40    110   67    21    42    27    
     19    41    27    40    109   67    21    42    27    

bg   0     0     0     0     0     0     0     0     0     
     0     0     0     0     0     0     0     0     0     
     0     0     0     0     0     0     0     0     0     
     0     0     0     0     0     0     0     0     0     

B3   3     19    28    5     50    76    4     23    34    
     3     19    28    5     50    76    4     23    34    
     3     19    28    5     50    76    4     23    34    
     3     19    28    5     50    76    4     23    34    

bg   0     0     0     0     0     0     0     0     0     
     0     0     0     0     0     0     0     0     0     
     0     0     0     0     0     0     0     0     0     
     0     0     0     0     0     0     0     0     0     

C1   4     4     2     33    32    11    80    71    22    
     4     4     2     33    33    11    80    71    22    
     4     4     2     33    33    11    80    71    22    
     4     4     2     33    33    11    80    71    22    

bg   0     0     0     0     0     0     0     0     0     
     0     0     0     0     0     0     0     0     0     
     0     0     0     0     0     0     0     0     0     
     0     0     0     0     0     0     0     0     0     

C2   3     5     3     22    49    33    53    111   68    
     3     5     3     22    49    33    53    110   68    
     3     5     3     22    49    33    53    110   67    
     3     5     3     22    49    33    53    109   67    

bg   0     0     0     0     0     0     0     0     0     
     0     0     0     0     0     0     0     0     0     
     0     0     0     0     0     0     0     0     0     
     0     0     0     0     0     0     0     0     0     

C3   2     3     3     3     23    32    8     49    73    
     2     3     3     4     23    32    8     49    73    
     2     3     3     4     23    32    8     49    73    
     2     3     3     4     23    32    8     50    73    

bg   0     0     0     0     0     0     0     0     0     
     0     0     0     0     0     0     0     0     0     
     0     0     0     0     0     0     0     0     0     
     0     0     0     0     0     0     0     0     0     
