Trial #1-------------------------

     A1    A2    A3    B1    B2    B3    C1    C2    C3    

A1   5     5     3     3     4     3     2     3     3     
     5     5     3     3     4     3     2     3     3     
     5     5     3     3     4     3     2     3     3     
     5     5     3     3     4     3     2     3     3     

bg   1     2     2     2     2     2     2     3     3     
     1     2     2     2     2     2     2     3     3     
     1     2     2     2     2     2     2     3     3     
     1     2     2     2     2     2     2     3     3     

A2   3     7     5     2     5     4     2     3     3     
     3     7     5     2     5     4     2     3     3     
     3     7     5     2     5     4     2     3     3     
     3     7     5     2     5     4     2     3     3     

bg   1     2     2     2     2     2     2     3     3     
     1     2     2     2     2     2     2     3     3     
     1     2     2     2     2     2     2     3     3     
     1     2     2     2     2     2     2     3     3     

A3   2     4     6     2     3     4     2     3     3     
     2     4     6     2     3     4     2     3     3     
     2     4     6     2     3     4     2     3     3     
     2     4     6     2     3     4     2     3     3     

bg   1     2     2     2     2     2     2     3     3     
     1     2     2     2     2     2     2     3     3     
     1     2     2     2     2     2     2     3     3     
     1     2     2     2     2     2     2     3     3     

B1   3     3     2     5     6     3     4     5     3     
     3     3     2     5     6     3     4     5     3     
     3     3     2     5     6     3     4     5     3     
     3     3     2     5     6     3     4     5     3     

bg   1     2     2     2     2     2     2     3     3     
     1     2     2     2     2     2     2     3     3     
     1     2     2     2     2     2     2     3     3     
     1     2     2     2     2     2     2     3     3     

B2   2     4     3     4     8     6     3     5     4     
     2     4     3     4     8     6     3     5     4     
     2     4     3     4     8     6     3     5     4     
     2     4     3     4     8     6     3     5     4     

bg   1     2     2     2     2     2     2     3     3     
     1     2     2     2     2     2     2     3     3     
     1     2     2     2     2     2     2     3     3     
     1     2     2     2     2     2     2     3     3     

B3   1     3     3     2     5     6     2     4     5     
     1     3     3     2     5     6     2     4     5     
     1     3     3     2     5     6     2     4     5     
     1     3     3     2     5     6     2     4     5     

bg   1     2     2     2     2     2     2     3     3     
     1     2     2     2     2     2     2     3     3     
     1     2     2     2     2     2     2     3     3     
     1     2     2     2     2     2     2     3     3     

C1   1     2     2     3     4     3     6     7     4     
     1     2     2     3     4     3     6     7     4     
     1     2     2     3     4     3     6     7     4     
     1     2     2     3     4     3     6     7     4     

bg   1     2     2     2     2     2     2     3     3     
     1     2     2     2     2     2     2     3     3     
     1     2     2     2     2     2     2     3     3     
     1     2     2     2     2     2     2     3     3     

C2   1     2     2     2     4     4     5     9     6     
     1     2     2     2     4     4     5     9     6     
     1     2     2     2     4     4     5     9     6     
     1     2     2     2     4     4     5     9     6     

bg   1     2     2     2     2     2     2     3     3     
     1     2     2     2     2     2     2     3     3     
     1     2     2     2     2     2     2     3     3     
     1     2     2     2     2     2     2     3     3     

C3   1     2     2     2     3     4     2     6     7     
     1     2     2     2     3     4     2     6     7     
     1     2     2     2     3     4     2     6     7     
     1     2     2     2     3     4     2     6     7     

bg   1     2     2     2     2     2     2     3     3     
     1     2     2     2     2     2     2     3     3     
     1     2     2     2     2     2     2     3     3     
     1     2     2     2     2     2     2     3     3     


Trial #2-------------------------

     A1    A2    A3    B1    B2    B3    C1    C2    C3    

A1   5     5     3     3     4     3     2     3     3     
     5     5     3     3     4     3     2     3     3     
     5     5     3     3     4     3     2     3     3     
     5     5     3     3     4     3     2     3     3     

bg   1     2     2     2     2     2     2     3     3     
     1     2     2     2     2     2     2     3     3     
     1     2     2     2     2     2     2     3     3     
     1     2     2     2     2     2     2     3     3     

A2   3     7     5     2     5     4     2     3     3     
     3     7     5     2     5     4     2     3     3     
     3     7     5     2     5     4     2     3     3     
     3     7     5     2     5     4     2     3     3     

bg   1     2     2     2     2     2     2     3     3     
     1     2     2     2     2     2     2     3     3     
     1     2     2     2     2     2     2     3     3     
     1     2     2     2     2     2     2     3     3     

A3   2     4     6     2     3     4     2     3     3     
     2     4     6     2     3     4     2     3     3     
     2     4     6     2     3     4     2     3     3     
     2     4     6     2     3     4     2     3     3     

bg   1     2     2     2     2     2     2     3     3     
     1     2     2     2     2     2     2     3     3     
     1     2     2     2     2     2     2     3     3     
     1     2     2     2     2     2     2     3     3     

B1   3     3     2     5     5     3     4     5     3     
     3     3     2     5     6     3     4     5     3     
     3     3     2     5     5     3     4     5     3     
     3     3     2     5     5     3     4     5     3     

bg   1     2     2     2     2     2     2     3     3     
     1     2     2     2     2     2     2     3     3     
     1     2     2     2     2     2     2     3     3     
     1     2     2     2     2     2     2     3     3     

B2   2     4     3     4     8     6     3     5     4     
     2     4     3     4     8     6     3     5     4     
     2     4     3     4     8     6     3     5     4     
     2     4     3     4     8     6     3     5     4     

bg   1     2     2     2     2     2     2     3     3     
     1     2     2     2     2     2     2     3     3     
     1     2     2     2     2     2     2     3     3     
     1     2     2     2     2     2     2     3     3     

B3   1     3     4     2     5     7     2     5     5     
     1     3     4     2     5     7     2     5     5     
     1     3     4     2     5     7     2     5     5     
     1     3     4     2     5     6     2     5     5     

bg   1     2     2     2     2     2     2     3     3     
     1     2     2     2     2     2     2     3     3     
     1     2     2     2     2     2     2     3     3     
     1     2     2     2     2     2     2     3     3     

C1   1     2     2     3     4     3     6     7     4     
     1     2     2     3     4     3     6     7     4     
     1     2     2     3     4     3     6     7     4     
     1     2     2     3     4     3     6     7     4     

bg   1     2     2     2     2     2     2     3     3     
     1     2     2     2     2     2     2     3     3     
     1     2     2     2     2     2     2     3     3     
     1     2     2     2     2     2     2     3     3     

C2   1     2     2     2     4     4     5     9     6     
     1     2     2     2     4     4     5     9     6     
     1     2     2     2     4     4     5     9     6     
     1     2     2     2     4     4     5     9     6     

bg   1     2     2     2     2     2     2     3     3     
     1     2     2     2     2     2     2     3     3     
     1     2     2     2     2     2     2     3     3     
     1     2     2     2     2     2     2     3     3     

C3   1     2     2     2     3     4     2     6     7     
     1     2     2     2     3     4     2     6     7     
     1     2     2     2     3     4     2     6     7     
     1     2     2     2     3     4     2     6     7     

bg   1     2     2     2     2     2     2     3     3     
     1     2     2     2     2     2     2     3     3     
     1     2     2     2     2     2     2     3     3     
     1     2     2     2     2     2     2     3     3     


Trial #3-------------------------

     A1    A2    A3    B1    B2    B3    C1    C2    C3    

A1   5     5     3     3     4     3     2     3     3     
     5     5     3     3     4     3     2     3     3     
     5     5     3     3     4     3     2     3     3     
     5     5     3     3     4     3     2     3     3     

bg   1     2     2     2     2     2     2     3     3     
     1     2     2     2     2     2     2     3     3     
     1     2     2     2     2     2     2     3     3     
     1     2     2     2     2     2     2     3     3     

A2   3     7     5     2     5     4     2     3     3     
     3     7     5     2     5     4     2     3     3     
     3     7     5     2     5     4     2     3     3     
     3     7     5     2     5     4     2     3     3     

bg   1     2     2     2     2     2     2     3     3     
     1     2     2     2     2     2     2     3     3     
     1     2     2     2     2     2     2     3     3     
     1     2     2     2     2     2     2     3     3     

A3   2     4     6     2     3     4     2     3     3     
     2     4     6     2     3     4     2     3     3     
     2     4     6     2     3     4     2     3     3     
     2     4     6     2     3     4     2     3     3     

bg   1     2     2     2     2     2     2     3     3     
     1     2     2     2     2     2     2     3     3     
     1     2     2     2     2     2     2     3     3     
     1     2     2     2     2     2     2     3     3     

B1   3     3     2     5     5     3     4     5     3     
     3     3     2     5     5     3     4     5     3     
     3     3     2     5     5     3     4     5     3     
     3     3     2     5     5     3     4     5     3     

bg   1     2     2     2     2     2     2     3     3     
     1     2     2     2     2     2     2     3     3     
     1     2     2     2     2     2     2     3     3     
     1     2     2     2     2     2     2     3     3     

B2   2     4     3     4     8     6     3     5     4     
     2     4     3     4     8     6     3     5     4     
     2     4     3     4     8     6     3     5     4     
     2     4     3     4     8     6     3     5     4     

bg   1     2     2     2     2     2     2     3     3     
     1     2     2     2     2     2     2     3     3     
     1     2     2     2     2     2     2     3     3     
     1     2     2     2     2     2     2     3     3     

B3   1     3     3     2     5     6     2     4     5     
     1     3     3     2     5     6     2     4     5     
     1     3     3     2     5     6     2     4     5     
     1     3     3     2     5     6     2     4     5     

bg   1     2     2     2     2     2     2     3     3     
     1     2     2     2     2     2     2     3     3     
     1     2     2     2     2     2     2     3     3     
     1     2     2     2     2     2     2     3     3     

C1   1     2     2     3     4     3     6     7     4     
     1     2     2     3     4     3     6     7     4     
     1     2     2     3     4     3     6     7     4     
     1     2     2     3     4     3     6     7     4     

bg   1     2     2     2     2     2     2     3     3     
     1     2     2     2     2     2     2     3     3     
     1     2     2     2     2     2     2     3     3     
     1     2     2     2     2     2     2     3     3     

C2   1     2     2     2     4     4     5     9     6     
     1     2     2     2     4     4     5     9     6     
     1     2     2     2     4     4     5     9     6     
     1     2     2     2     4     4     5     9     6     

bg   1     2     2     2     2     2     2     3     3     
     1     2     2     2     2     2     2     3     3     
     1     2     2     2     2     2     2     3     3     
     1     2     2     2     2     2     2     3     3     

C3   1     2     2     2     3     4     2     6     7     
     1     2     2     2     3     4     2     6     7     
     1     2     2     2     3     4     2     6     7     
     1     2     2     2     3     4     2     6     7     

bg   1     2     2     2     2     2     2     3     3     
     1     2     2     2     2     2     2     3     3     
     1     2     2     2     2     2     2     3     3     
     1     2     2     2     2     2     2     3     3     


Trial #4-------------------------

     A1    A2    A3    B1    B2    B3    C1    C2    C3    

A1   5     5     3     3     4     3     2     3     3     
     5     5     3     3     4     3     2     3     3     
     5     5     3     3     4     3     2     3     3     
     5     5     3     3     4     3     2     3     3     

bg   1     2     2     2     2     2     2     3     3     
     1     2     2     2     2     2     2     3     3     
     1     2     2     2     2     2     2     3     3     
     1     2     2     2     2     2     2     3     3     

A2   3     7     5     2     5     4     2     3     3     
     3     7     5     2     5     4     2     3     3     
     3     7     5     2     5     4     2     3     3     
     3     7     5     2     5     4     2     3     3     

bg   1     2     2     2     2     2     2     3     3     
     1     2     2     2     2     2     2     3     3     
     1     2     2     2     2     2     2     3     3     
     1     2     2     2     2     2     2     3     3     

A3   1     4     6     2     3     4     2     3     3     
     1     4     6     2     3     4     2     3     3     
     2     4     6     2     3     4     2     3     3     
     2     4     6     2     3     4     2     3     3     

bg   1     2     2     2     2     2     2     3     3     
     1     2     2     2     2     2     2     3     3     
     1     2     2     2     2     2     2     3     3     
     1     2     2     2     2     2     2     3     3     

B1   3     3     2     5     5     3     4     5     3     
     3     3     2     5     5     3     4     5     3     
     3     3     2     5     5     3     4     5     3     
     3     3     2     5     5     3     4     5     3     

bg   1     2     2     2     2     2     2     3     3     
     1     2     2     2     2     2     2     3     3     
     1     2     2     2     2     2     2     3     3     
     1     2     2     2     2     2     2     3     3     

B2   2     4     3     4     8     6     3     5     4     
     2     4     3     4     8     6     3     5     4     
     2     4     3     4     8     6     3     5     4     
     2     4     3     4     8     6     3     5     4     

bg   1     2     2     2     2     2     2     3     3     
     1     2     2     2     2     2     2     3     3     
     1     2     2     2     2     2     2     3     3     
     1     2     2     2     2     2     2     3     3     

B3   1     3     3     2     5     6     2     4     5     
     1     3     3     2     5     6     2     4     5     
     1     3     3     2     5     6     2     4     5     
     1     3     3     2     5     6     2     4     5     

bg   1     2     2     2     2     2     2     3     3     
     1     2     2     2     2     2     2     3     3     
     1     2     2     2     2     2     2     3     3     
     1     2     2     2     2     2     2     3     3     

C1   1     2     2     3     4     3     6     7     4     
     1     2     2     3     4     3     6     7     4     
     1     2     2     3     4     3     6     7     4     
     1     2     2     3     4     3     6     7     4     

bg   1     2     2     2     2     2     2     3     3     
     1     2     2     2     2     2     2     3     3     
     1     2     2     2     2     2     2     3     3     
     1     2     2     2     2     2     2     3     3     

C2   1     2     2     2     4     4     5     9     6     
     1     2     2     2     4     4     5     9     6     
     1     2     2     2     4     4     4     9     6     
     1     2     2     2     4     4     5     9     6     

bg   1     2     2     2     2     2     2     3     3     
     1     2     2     2     2     2     2     3     3     
     1     2     2     2     2     2     2     3     3     
     1     2     2     2     2     2     2     3     3     

C3   1     2     2     2     3     4     2     6     7     
     1     2     2     2     3     4     2     6     7     
     1     2     2     2     3     4     2     6     7     
     1     2     2     2     3     4     2     6     7     

bg   1     2     2     2     2     2     2     3     3     
     1     2     2     2     2     2     2     3     3     
     1     2     2     2     2     2     2     3     3     
     1     2     2     2     2     2     2     3     3     

