     A1    A2    A3    B1    B2    B3    C1    C2    C3    

On   374   566   434   411   641   473   388   591   437   
     375   566   434   411   642   473   388   591   437   
     375   567   434   412   642   472   388   591   437   
     375   566   433   412   641   472   388   591   437   

Off  326   476   367   348   530   391   334   484   360   
     326   476   368   348   530   391   333   484   360   
     325   476   368   347   530   391   333   483   361   
     325   476   369   347   530   392   332   484   361   

