     A1    A2    A3    B1    B2    B3    C1    C2    C3    

On   407   617   472   437   689   512   410   612   465   
     407   617   472   436   689   512   410   612   465   
     404   608   467   438   685   506   427   617   463   
     402   608   466   438   683   505   436   623   463   

Off  357   520   401   408   603   434   358   593   408   
     357   520   401   408   603   434   358   593   408   
     354   518   399   391   574   423   358   535   389   
     354   517   399   376   573   423   358   519   389   

