     A1    A2    A3    B1    B2    B3    C1    C2    C3    

On   371   565   437   408   640   477   385   590   442   
     373   566   436   409   641   476   386   591   442   
     374   566   435   411   642   475   388   592   440   
     375   566   434   412   642   474   389   592   440   

Off  327   475   366   349   530   390   335   484   361   
     327   475   366   350   530   389   336   484   360   
     327   475   366   350   530   390   336   484   360   
     327   475   366   349   530   390   335   484   361   

