Trial #21-------------------------

     A1    A2    A3    B1    B2    B3    C1    C2    C3    

A1   58    195   74    60    123   93    73    100   90    
     1070   1073   439   551   654   384   303   424   380   
     1056   1063   439   547   653   387   307   428   384   
     1030   1039   432   535   641   386   306   422   380   

bg   1020   1030   429   530   636   379   300   420   377   
     377   387   251   179   364   288   258   390   354   
     155   215   216   180   288   280   255   384   356   
     155   214   215   180   288   279   254   383   356   

A2   154   761   215   241   520   279   254   403   369   
     711   1575   1047   415   857   629   290   436   399   
     710   1569   1043   415   855   629   291   436   400   
     709   1563   1040   414   853   628   291   437   400   

bg   613   1527   794   412   824   534   277   433   399   
     154   213   214   209   287   279   253   382   357   
     154   214   215   180   287   279   254   382   356   
     155   214   215   180   287   280   254   383   355   

A3   154   214   215   180   287   279   254   382   355   
     224   833   1221   219   565   620   271   414   407   
     236   830   1226   218   564   653   270   413   406   
     237   828   1216   219   565   651   271   415   407   

bg   237   689   1211   217   487   649   271   405   398   
     154   214   490   179   287   279   258   382   355   
     155   214   215   180   288   280   255   383   356   
     155   214   215   180   288   280   255   383   356   

B1   269   214   215   180   288   343   255   384   356   
     518   523   312   1075   1056   488   647   728   443   
     519   566   313   1072   1090   489   647   743   463   
     519   565   313   1068   1087   489   645   741   463   

bg   507   565   291   791   1084   488   565   740   462   
     154   214   215   179   287   281   254   382   355   
     154   214   215   180   287   279   254   382   355   
     155   214   215   180   287   279   254   383   355   

B2   154   278   214   179   591   279   254   494   378   
     340   782   564   662   1702   1139   467   888   706   
     404   781   579   701   1691   1135   486   884   704   
     404   779   578   698   1683   1130   486   881   701   

bg   404   777   577   697   1669   831   485   877   700   
     154   361   214   179   488   278   253   449   458   
     154   214   215   179   288   279   254   383   355   
     154   214   214   179   287   279   254   382   355   

B3   162   311   383   188   286   297   270   381   504   
     200   495   619   256   968   1323   305   690   828   
     200   496   618   256   966   1317   305   689   826   
     200   496   618   256   964   1306   305   688   824   

bg   200   495   555   256   882   1303   302   646   821   
     159   220   214   199   286   580   253   380   378   
     154   213   214   179   286   278   253   381   354   
     154   213   214   179   287   278   253   382   354   

C1   155   215   216   320   289   331   256   385   357   
     196   259   237   572   567   408   1020   1099   599   
     194   257   237   570   651   406   1217   1291   596   
     194   256   237   568   650   404   1213   1287   594   

bg   181   246   237   566   506   396   1210   909   545   
     153   212   213   191   285   276   252   379   352   
     153   212   213   178   285   277   252   380   353   
     154   213   214   179   286   278   253   381   353   

C2   155   213   227   179   300   278   386   453   354   
     184   254   251   419   835   571   873   1885   1084   
     184   262   251   419   834   669   872   1877   1228   
     184   262   250   419   833   668   870   1864   1225   

bg   184   262   247   375   832   500   868   1858   1222   
     161   213   214   179   286   278   292   837   353   
     154   213   214   179   286   278   253   380   353   
     153   212   213   179   285   277   252   380   353   

C3   154   215   214   179   367   324   253   594   437   
     172   246   251   209   557   704   327   1033   1398   
     171   246   258   217   558   704   327   1032   1394   
     171   246   258   218   557   703   327   1030   1387   

bg   168   246   258   202   558   703   300   1029   1384   
     155   214   215   180   304   366   254   403   653   
     155   214   215   180   287   279   254   383   355   
     154   214   215   180   287   279   254   383   355   


Trial #22-------------------------

     A1    A2    A3    B1    B2    B3    C1    C2    C3    

A1   154   488   282   185   287   279   258   383   363   
     993   1071   438   551   651   382   303   422   379   
     1057   1060   435   545   647   382   302   423   379   
     1033   1049   433   536   643   382   302   423   380   

bg   1024   1033   423   532   564   365   302   413   380   
     155   264   215   180   288   280   264   384   357   
     155   215   215   180   288   280   255   384   356   
     155   215   215   180   288   280   255   384   356   

A2   347   215   216   236   289   281   255   385   357   
     714   1579   858   417   774   576   291   433   401   
     712   1572   1045   416   856   630   291   437   400   
     711   1567   1042   415   853   628   291   436   400   

bg   677   1327   1039   414   852   628   283   437   391   
     157   215   216   218   288   280   256   384   357   
     158   215   216   183   288   280   256   384   357   
     159   216   216   184   289   281   257   385   357   

A3   159   215   411   184   309   338   257   388   357   
     218   682   1232   222   566   655   272   415   398   
     239   829   1225   221   565   652   272   414   406   
     239   827   1219   221   563   650   272   413   405   

bg   240   597   1210   220   563   647   272   413   405   
     158   214   285   182   366   338   261   389   355   
     158   214   215   182   288   279   256   383   355   
     158   214   215   182   287   279   256   382   355   

B1   233   224   215   182   601   279   408   539   364   
     523   567   283   1080   1097   488   650   745   461   
     523   566   314   1076   1093   489   649   744   461   
     523   565   313   1073   1091   489   648   743   461   

bg   521   564   269   817   1066   435   603   711   459   
     184   212   213   181   285   277   254   380   382   
     156   212   213   180   284   276   253   379   351   
     156   212   213   180   284   276   253   378   351   

B2   156   362   271   180   283   275   252   377   470   
     404   777   575   645   1689   1065   441   732   698   
     404   776   575   699   1679   1126   483   875   697   
     404   775   574   697   1672   1122   482   873   695   

bg   316   772   573   695   1260   1118   482   698   692   
     154   271   245   178   280   272   249   373   355   
     154   209   210   178   280   272   249   373   346   
     154   209   209   178   280   272   249   373   346   

B3   158   209   210   186   281   560   263   374   346   
     201   493   616   256   913   1317   303   679   822   
     202   493   614   257   958   1311   304   685   819   
     198   489   611   253   953   1301   299   674   812   

bg   198   454   462   253   952   1292   298   674   705   
     162   206   207   198   277   312   248   368   342   
     152   206   207   175   276   268   246   367   341   
     151   205   206   175   276   268   245   366   340   

C1   151   205   208   302   346   267   245   601   339   
     191   237   229   565   640   393   912   1282   546   
     191   247   228   564   639   393   1207   1275   579   
     191   247   227   563   637   392   1203   1271   578   

bg   181   230   226   561   636   350   812   1264   577   
     150   203   205   196   333   263   243   454   336   
     149   202   195   172   271   261   242   361   334   
     147   201   199   171   271   260   241   360   334   

C2   146   199   201   171   270   263   312   360   424   
     174   248   237   411   820   655   861   1860   1216   
     176   249   237   411   818   654   859   1852   1211   
     176   249   233   411   817   648   856   1845   1201   

bg   177   249   218   373   758   645   855   1581   1196   
     148   200   198   170   268   380   338   356   560   
     148   200   200   170   268   260   238   356   330   
     147   200   200   169   267   260   237   355   330   

C3   152   206   201   168   266   411   236   353   699   
     163   231   243   197   464   681   309   878   1363   
     163   230   242   206   534   680   308   997   1358   
     163   230   241   206   534   679   308   995   1353   

bg   160   229   241   190   431   659   287   993   1346   
     144   201   206   166   262   255   233   348   336   
     144   195   196   166   262   255   233   348   323   
     144   195   196   166   262   254   232   347   322   


Trial #23-------------------------

     A1    A2    A3    B1    B2    B3    C1    C2    C3    

A1   144   195   196   165   266   254   232   350   322   
     886   1051   418   535   628   329   280   386   345   
     1034   1038   415   531   622   356   280   385   344   
     1023   1029   414   521   615   356   279   385   345   

bg   1013   936   355   516   610   311   277   382   336   
     142   192   193   163   257   250   243   352   318   
     142   192   193   164   258   250   230   343   317   
     142   191   192   163   258   250   229   342   318   

A2   274   191   184   212   418   274   243   359   312   
     700   1162   1007   399   828   597   264   393   351   
     698   1549   1022   397   825   598   263   392   359   
     696   1542   1015   395   822   596   262   391   357   

bg   694   1092   1013   395   819   596   257   390   358   
     160   186   423   202   297   326   225   336   312   
     137   186   187   160   253   246   224   335   312   
     137   186   187   159   252   245   224   334   311   

A3   137   186   598   175   252   245   224   334   315   
     188   749   1196   198   529   612   237   364   359   
     219   801   1189   198   527   610   239   363   355   
     219   799   1186   197   527   610   238   363   356   

bg   191   797   1044   197   486   580   238   355   358   
     137   186   186   158   250   243   222   332   323   
     137   185   186   158   250   243   221   331   307   
     137   185   186   158   250   243   221   330   307   

B1   175   252   187   158   250   243   339   332   351   
     506   544   280   1061   928   418   622   673   420   
     503   540   284   1055   1057   452   616   691   414   
     502   538   284   1051   1053   452   614   689   414   

bg   502   537   284   815   1050   451   609   688   413   
     201   252   185   157   248   241   220   328   306   
     135   183   184   156   246   240   219   327   305   
     135   183   184   156   246   240   219   326   304   

B2   135   423   321   156   373   384   219   422   304   
     385   752   549   613   1665   1105   387   833   654   
     385   751   549   678   1655   1099   452   830   653   
     385   750   548   676   1638   1090   451   824   651   

bg   323   725   507   675   1632   1087   451   823   564   
     135   183   184   156   622   366   218   411   303   
     136   183   184   156   246   239   218   326   303   
     136   183   183   156   246   239   218   326   303   

B3   136   182   183   162   491   239   226   326   303   
     180   465   525   234   928   1281   271   636   720   
     182   466   588   234   926   1274   271   635   775   
     181   466   587   233   924   1270   271   634   773   

bg   181   386   587   233   921   1049   270   601   771   
     149   183   183   179   247   239   225   326   303   
     135   183   183   155   246   239   218   326   303   
     135   183   183   155   245   239   218   325   303   

C1   150   182   187   275   245   236   217   324   331   
     174   221   201   546   610   348   1186   1008   540   
     174   224   198   545   609   355   1181   1234   537   
     173   224   196   544   608   356   1177   1230   536   

bg   168   224   194   542   510   356   878   882   535   
     133   180   172   185   244   228   217   324   353   
     133   181   173   154   244   230   217   324   297   
     133   181   174   155   244   230   217   324   297   

C2   133   188   173   155   244   328   230   346   632   
     158   230   202   393   737   619   833   1817   1170   
     163   230   210   393   787   618   831   1808   1165   
     163   230   209   393   787   617   828   1795   1161   

bg   163   230   210   361   786   617   828   1791   1149   
     134   193   179   155   244   259   375   324   299   
     134   182   180   155   245   235   217   325   299   
     134   182   181   155   245   237   217   324   300   

C3   139   193   190   155   291   236   217   514   299   
     151   213   221   183   513   657   290   972   1333   
     151   213   220   192   513   655   290   970   1329   
     150   212   217   192   513   653   289   968   1324   

bg   150   212   215   178   513   527   276   966   1049   
     133   180   174   154   293   231   216   364   296   
     133   180   173   154   242   230   215   321   296   
     133   180   173   154   242   230   215   322   295   


Trial #24-------------------------

     A1    A2    A3    B1    B2    B3    C1    C2    C3    

A1   133   180   173   154   242   231   215   322   296   
     783   1034   336   516   607   333   260   362   318   
     1024   1022   392   519   602   334   263   361   319   
     1013   1011   390   509   598   332   263   361   319   

bg   1004   794   289   505   562   332   263   351   319   
     132   179   172   153   241   229   214   320   294   
     132   179   172   153   241   229   214   320   294   
     132   179   172   153   242   229   214   320   294   

A2   208   179   328   197   242   349   227   321   301   
     692   1365   1011   389   654   581   251   366   338   
     691   1538   1006   389   810   580   251   373   338   
     688   1533   1002   387   808   578   250   372   338   

bg   687   1528   996   387   605   570   249   373   337   
     211   177   235   199   240   227   213   318   302   
     132   178   172   152   240   228   213   319   293   
     131   178   171   152   240   228   213   318   292   

A3   131   212   171   166   239   228   213   320   309   
     212   798   1185   191   502   473   224   349   340   
     213   795   1179   191   517   598   229   349   340   
     213   790   1174   191   516   597   229   349   340   

bg   193   788   823   190   516   470   229   349   340   
     131   372   171   152   240   228   213   326   292   
     132   179   173   153   242   230   215   320   294   
     131   177   171   151   239   227   212   316   290   

B1   132   298   183   151   451   241   289   465   292   
     494   529   269   1046   1048   437   607   681   399   
     494   528   269   1041   1043   437   605   678   399   
     494   528   270   1038   1040   437   603   677   400   

bg   493   527   270   822   1035   437   601   660   369   
     231   188   185   151   319   280   246   317   291   
     131   177   171   151   239   227   212   317   291   
     131   177   172   151   239   228   212   317   291   

B2   131   177   172   151   239   590   212   317   291   
     380   745   537   596   1649   1090   445   821   608   
     380   743   538   672   1639   1084   444   817   639   
     380   743   539   670   1632   1082   444   815   639   

bg   343   628   424   668   1395   992   364   656   639   
     131   178   178   152   239   232   212   317   295   
     131   178   178   152   239   233   212   317   295   
     131   178   178   151   239   232   212   317   294   

B3   132   178   198   156   239   233   215   317   366   
     171   408   583   229   783   1048   265   611   770   
     178   460   583   229   918   1266   265   625   767   
     178   460   582   229   916   1262   265   624   764   

bg   178   460   582   229   915   1258   265   623   762   
     132   178   265   152   240   233   224   318   398   
     132   178   179   152   240   233   213   318   296   
     132   178   179   152   240   233   213   318   296   

C1   144   181   179   265   266   252   213   527   395   
     173   222   203   545   607   361   1186   1238   539   
     173   222   204   544   607   362   1182   1234   540   
     174   223   204   544   607   363   1178   1232   541   

bg   172   223   198   542   607   362   969   1224   530   
     133   179   180   192   348   257   215   440   298   
     132   179   180   153   241   235   214   320   297   
     133   179   180   153   241   235   214   320   297   

C2   133   194   180   153   426   235   214   320   297   
     155   229   217   392   786   623   786   1808   1169   
     163   229   217   392   785   623   829   1801   1166   
     163   229   217   392   785   623   827   1795   1163   

bg   163   229   217   364   784   550   826   1580   911   
     133   184   191   154   253   236   215   321   298   
     134   181   182   154   243   236   216   322   299   
     134   180   181   154   243   236   216   322   300   

C3   136   180   202   154   243   236   242   322   299   
     151   213   225   182   513   605   289   829   1252   
     151   213   225   192   513   660   289   970   1332   
     151   213   225   192   513   660   289   968   1328   

bg   151   207   216   179   446   659   283   696   1326   
     135   180   181   154   242   236   215   322   299   
     134   181   181   154   243   236   216   322   300   
     134   181   182   154   243   237   216   323   300   

