Trial #21-------------------------

     A1    A2    A3    B1    B2    B3    C1    C2    C3    

A1   178   273   159   160   211   150   136   192   174   
     1215   1274   636   725   923   639   551   788   713   
     1202   1264   634   720   920   640   552   790   716   
     1182   1248   636   714   917   643   556   795   721   

bg   1170   1235   626   706   907   636   548   786   713   
     447   564   411   422   613   549   502   755   687   
     298   411   409   350   552   531   498   743   686   
     297   410   408   350   551   530   496   742   685   

A2   298   1002   409   447   551   531   497   765   699   
     858   1777   1029   588   1126   884   534   797   730   
     857   1771   1240   587   1123   882   534   797   730   
     855   1765   1237   586   1120   880   533   795   729   

bg   711   1691   1233   581   1062   807   519   792   727   
     297   409   407   349   550   530   496   741   686   
     297   409   407   349   550   529   496   740   681   
     296   408   406   348   548   527   494   738   681   

A3   296   408   566   348   548   528   495   738   681   
     372   1029   1427   386   739   845   510   769   730   
     378   1027   1422   386   826   902   510   769   729   
     379   1026   1418   387   828   902   512   771   731   

bg   379   875   1409   379   737   901   511   760   723   
     325   407   515   346   546   526   496   736   679   
     294   407   405   346   546   526   491   735   679   
     296   407   409   349   547   528   494   737   685   

B1   434   407   407   346   546   573   495   736   680   
     662   722   504   1096   1348   738   891   1080   765   
     662   761   505   1245   1360   738   890   1099   787   
     661   760   503   1241   1352   736   887   1097   785   

bg   624   759   464   1238   1348   734   799   1095   738   
     293   405   403   344   543   541   490   731   675   
     293   404   403   344   543   523   489   731   675   
     296   405   403   345   545   527   489   733   675   

B2   296   482   451   374   907   529   494   848   700   
     498   975   769   873   1963   1388   710   1241   1029   
     544   974   768   870   1952   1382   723   1236   1025   
     544   973   768   867   1946   1380   724   1235   1025   

bg   544   971   767   865   1932   1135   723   1231   1023   
     296   546   456   348   700   526   494   805   682   
     295   406   404   346   545   527   491   734   678   
     294   407   405   346   546   524   492   736   678   

B3   306   508   406   367   547   527   512   737   822   
     340   689   810   423   1230   1524   542   1044   1154   
     340   689   809   423   1228   1567   542   1043   1152   
     340   689   809   423   1225   1554   542   1042   1149   

bg   340   688   682   423   1125   1549   539   1004   1145   
     295   410   401   354   541   521   488   729   709   
     292   403   402   344   541   522   487   729   675   
     295   407   404   347   546   526   492   736   679   

C1   293   404   403   344   543   561   489   731   675   
     334   446   424   739   826   648   1263   1426   916   
     336   449   426   741   913   652   1465   1652   921   
     335   448   425   739   910   651   1458   1644   918   

bg   318   437   424   704   759   648   1455   1284   872   
     292   403   406   343   541   522   487   728   672   
     292   403   402   343   541   521   488   729   672   
     293   402   401   342   542   520   488   731   670   

C2   293   401   399   341   556   518   618   757   668   
     321   442   436   581   1085   908   1103   2224   1369   
     321   450   436   581   1084   907   1102   2218   1541   
     321   450   436   581   1083   907   1100   2206   1539   

bg   321   451   428   510   1083   772   1099   2202   1171   
     296   400   399   341   537   517   524   723   667   
     290   400   398   340   538   517   483   724   667   
     290   401   399   341   538   518   484   724   668   

C3   291   403   399   341   618   529   485   916   712   
     308   433   440   376   806   940   558   1372   1705   
     307   433   441   379   807   939   558   1371   1701   
     308   433   441   380   808   938   559   1371   1692   

bg   304   433   441   379   808   939   533   1369   1693   
     291   401   400   342   556   641   485   767   670   
     290   400   399   340   538   517   484   724   667   
     290   402   400   341   539   519   484   726   669   


Trial #22-------------------------

     A1    A2    A3    B1    B2    B3    C1    C2    C3    

A1   290   653   495   384   538   558   487   724   675   
     1154   1261   623   714   904   622   534   765   692   
     1194   1250   621   708   900   622   534   765   693   
     1171   1239   618   699   895   620   533   763   691   

bg   1163   1224   582   696   822   614   534   757   692   
     291   474   400   437   539   519   496   726   671   
     290   400   399   341   538   518   485   725   667   
     289   398   397   340   536   515   483   721   665   

A2   496   400   398   421   538   517   484   724   667   
     852   1768   1146   580   1017   782   523   770   714   
     851   1762   1231   579   1108   868   521   776   711   
     851   1758   1228   578   1107   868   522   777   712   

bg   806   1558   1226   579   1106   719   515   778   706   
     293   402   400   356   539   518   486   725   669   
     293   402   400   343   539   518   486   725   668   
     294   403   400   343   539   518   486   725   670   

A3   294   404   712   344   553   540   488   729   671   
     353   846   1419   381   816   893   499   754   702   
     375   1020   1414   382   817   892   502   755   716   
     374   1017   1409   381   814   888   500   752   714   

bg   373   809   1362   375   812   885   499   750   695   
     292   400   398   341   624   612   484   730   666   
     291   400   398   341   536   515   483   721   665   
     291   400   397   340   534   514   482   719   664   

B1   368   399   397   340   822   513   627   860   667   
     656   750   478   1027   1347   727   882   1088   774   
     655   752   496   1232   1340   724   878   1082   773   
     654   750   496   1228   1336   724   876   1081   771   

bg   653   749   495   896   1330   693   842   1069   770   
     316   398   396   339   542   513   481   718   662   
     290   400   398   340   533   514   481   718   665   
     290   400   398   341   534   513   481   718   664   

B2   290   527   496   340   533   513   481   718   766   
     538   967   760   858   1942   1226   669   1219   1014   
     538   963   757   862   1932   1365   711   1214   1007   
     538   962   757   857   1925   1361   710   1212   1006   

bg   448   958   753   854   1559   1355   708   1060   1000   
     288   482   393   337   530   510   478   713   685   
     288   395   394   337   529   509   477   712   656   
     287   395   393   336   528   508   476   710   656   

B3   291   395   393   351   529   687   488   711   656   
     334   677   688   414   1131   1551   529   998   1131   
     334   677   797   414   1208   1544   529   1019   1128   
     334   677   796   414   1206   1539   528   1018   1126   

bg   334   657   608   414   1204   1530   528   1017   1048   
     297   393   391   350   526   655   478   708   653   
     286   393   391   335   526   506   475   708   654   
     286   392   391   334   525   505   474   707   652   

C1   286   393   395   496   579   506   474   890   653   
     328   437   414   731   895   634   1454   1633   846   
     329   438   415   731   896   636   1450   1629   898   
     329   437   415   730   894   635   1445   1620   897   

bg   319   422   413   722   892   606   1085   1615   795   
     286   393   392   335   606   506   474   856   652   
     286   393   390   335   525   506   474   707   653   
     286   392   390   334   524   505   473   705   651   

C2   286   393   391   335   751   506   524   706   682   
     314   439   426   573   1071   854   1092   2202   1531   
     315   440   425   573   1069   893   1089   2192   1525   
     315   441   426   573   1069   894   1088   2188   1520   

bg   317   443   413   519   1047   896   1089   2025   1521   
     283   389   388   332   523   501   596   703   646   
     283   389   386   331   520   501   470   699   646   
     284   389   387   332   521   501   470   701   646   

C3   290   395   393   333   523   608   471   703   942   
     301   422   430   364   791   925   544   1185   1685   
     301   422   430   370   791   924   544   1347   1680   
     301   421   429   370   790   923   543   1346   1675   

bg   299   421   428   369   707   922   526   1099   1669   
     283   396   393   331   520   529   469   700   736   
     283   388   386   331   520   501   469   700   645   
     283   388   386   331   520   500   469   699   644   


Trial #23-------------------------

     A1    A2    A3    B1    B2    B3    C1    C2    C3    

A1   283   728   386   350   519   500   468   699   644   
     991   1247   609   704   868   604   516   739   668   
     1177   1235   607   698   879   603   518   738   668   
     1165   1225   604   688   875   601   516   735   667   

bg   1157   1202   533   685   872   570   516   735   662   
     283   387   386   331   520   499   469   700   643   
     287   391   391   335   527   506   474   708   651   
     283   386   387   330   519   502   467   697   640   

A2   391   386   422   393   637   498   480   712   642   
     843   1754   1225   567   1092   842   503   749   677   
     842   1749   1220   565   1089   849   502   746   685   
     841   1744   1213   565   1084   846   502   748   683   

bg   839   1406   1211   564   1083   846   499   747   666   
     330   386   566   357   605   498   465   698   641   
     282   388   386   330   519   500   468   698   646   
     281   386   383   328   516   496   465   693   641   

A3   282   387   384   329   517   604   467   696   642   
     363   893   1403   368   795   873   478   726   689   
     363   1003   1397   368   795   871   482   725   689   
     363   1002   1393   368   795   871   483   727   690   

bg   339   999   1191   366   778   868   482   721   689   
     280   385   383   328   516   510   465   694   640   
     280   385   383   328   516   496   465   694   640   
     280   385   383   328   516   496   465   694   640   

B1   296   417   383   328   515   496   555   693   669   
     645   737   477   1226   1113   639   862   997   746   
     645   737   481   1222   1321   706   861   1055   747   
     646   738   482   1219   1318   706   860   1055   747   

bg   645   737   482   942   1019   628   857   1054   747   
     367   486   381   327   513   494   485   690   648   
     279   383   381   326   513   493   462   690   636   
     279   383   381   326   513   494   463   690   637   

B2   279   569   537   326   514   531   463   743   637   
     528   950   744   809   1928   1357   695   1195   986   
     528   949   744   848   1918   1351   695   1192   985   
     528   948   744   846   1903   1342   694   1187   984   

bg   480   944   682   842   1893   1336   606   1183   924   
     278   410   379   324   510   722   460   812   633   
     278   381   379   325   510   491   460   686   633   
     277   381   379   324   509   490   459   685   633   

B3   279   382   381   336   690   907   467   804   636   
     318   662   738   401   1191   1529   511   994   1002   
     323   662   781   401   1189   1523   511   992   1102   
     322   662   780   400   1186   1517   510   990   1100   

bg   322   612   779   400   1182   1431   509   984   907   
     275   378   375   342   576   486   466   680   627   
     275   377   375   321   505   486   455   679   626   
     276   379   376   322   507   489   457   682   627   

C1   287   377   382   456   506   486   456   680   631   
     316   411   397   717   872   581   1434   1599   870   
     317   421   398   717   873   614   1431   1597   869   
     319   425   401   718   877   618   1430   1599   875   

bg   313   398   393   712   809   614   1195   1321   866   
     271   373   371   335   499   480   450   670   619   
     272   373   371   317   499   480   450   671   619   
     272   373   371   318   499   481   450   671   620   

C2   272   375   371   317   500   526   450   672   865   
     295   425   403   559   936   874   1038   2060   1502   
     302   424   408   558   1047   873   1070   2159   1497   
     303   424   409   558   1047   872   1068   2156   1492   

bg   303   424   409   519   814   872   1067   2151   1489   
     272   373   371   318   499   560   450   671   701   
     272   374   372   318   500   481   451   672   620   
     272   374   371   318   500   481   451   672   621   

C3   276   383   384   319   517   483   480   800   623   
     291   407   415   349   771   906   526   1324   1661   
     291   409   416   359   773   908   528   1326   1659   
     291   408   416   358   772   907   527   1321   1654   

bg   291   408   415   344   773   840   521   1321   1491   
     275   379   373   319   586   483   453   783   623   
     274   376   373   320   503   484   453   676   624   
     274   376   374   320   503   484   454   676   624   


Trial #24-------------------------

     A1    A2    A3    B1    B2    B3    C1    C2    C3    

A1   275   377   375   321   625   485   454   678   626   
     1185   1236   542   693   872   573   495   718   645   
     1172   1225   596   690   868   589   505   719   650   
     1161   1216   595   681   865   589   505   720   651   

bg   870   1108   593   677   859   589   505   716   642   
     275   378   376   322   520   487   456   680   628   
     276   378   376   322   506   487   457   681   628   
     276   378   376   322   506   487   456   680   628   

A2   292   378   546   371   505   555   464   680   628   
     838   1385   1217   560   1081   840   492   719   671   
     837   1743   1213   559   1079   839   493   734   671   
     835   1738   1209   559   1077   838   493   734   672   

bg   835   1256   1204   558   946   837   493   712   673   
     416   377   426   363   504   527   456   678   626   
     274   376   374   320   504   484   455   677   624   
     274   376   374   320   503   485   454   677   625   

A3   274   376   374   335   504   484   454   677   636   
     356   951   1393   360   730   861   470   707   673   
     356   997   1387   360   781   858   470   708   673   
     356   991   1381   359   780   856   469   706   671   

bg   347   991   1024   361   781   788   467   708   674   
     276   379   377   323   508   489   458   682   636   
     275   377   375   322   504   486   455   677   624   
     274   376   374   320   503   484   453   677   625   

B1   274   447   386   320   600   485   491   782   625   
     598   731   473   1221   1318   678   853   1044   733   
     640   730   473   1217   1313   695   851   1041   732   
     639   728   472   1213   1306   694   847   1039   732   

bg   639   728   473   989   1303   694   847   1037   716   
     273   439   387   320   700   483   527   703   624   
     274   376   374   320   504   484   454   677   623   
     274   376   374   320   503   484   453   676   624   

B2   351   376   374   320   1055   721   454   677   624   
     524   946   739   774   1920   1350   687   1182   902   
     524   945   739   844   1911   1345   688   1181   974   
     524   943   738   841   1903   1340   686   1176   971   

bg   518   910   620   839   1863   1333   630   1075   829   
     274   376   373   320   503   521   453   676   623   
     274   376   374   320   503   484   454   677   624   
     273   374   372   319   501   482   452   674   622   

B3   273   374   391   324   501   482   451   673   634   
     306   657   776   396   1182   1521   501   930   1096   
     318   657   776   396   1180   1514   504   980   1094   
     318   656   774   395   1177   1509   502   979   1089   

bg   318   575   774   395   985   1189   503   978   1088   
     271   372   457   317   498   480   467   670   618   
     271   372   370   317   498   479   449   670   618   
     271   372   369   316   497   479   448   668   617   

C1   278   372   369   428   498   479   824   762   686   
     312   411   391   708   831   603   1418   1584   857   
     311   414   391   707   860   603   1413   1576   855   
     311   414   392   706   859   604   1408   1570   856   

bg   311   414   385   704   859   603   1306   1566   854   
     275   370   368   356   495   476   446   898   636   
     269   370   368   315   495   476   446   665   613   
     269   370   367   315   495   476   446   665   614   

C2   269   376   367   314   592   611   445   1231   613   
     299   418   403   554   1042   866   952   2164   1491   
     299   419   403   555   1042   866   1063   2158   1489   
     299   419   404   554   1041   866   1062   2151   1486   

bg   289   419   403   528   1040   855   1061   2123   1343   
     268   380   377   313   594   474   444   663   611   
     268   367   365   313   492   473   443   661   610   
     268   367   365   313   492   473   443   661   610   

C3   268   379   383   313   492   473   461   661   610   
     284   399   407   340   759   770   515   1305   1423   
     285   400   407   351   760   894   516   1306   1638   
     286   401   409   352   763   895   519   1307   1637   

bg   285   399   399   338   739   729   516   1117   1209   
     272   367   365   312   491   473   445   660   609   
     267   367   365   312   491   472   443   660   609   
     268   367   365   312   492   472   443   659   609   

