Trial #1-------------------------

     A1    A2    A3    B1    B2    B3    C1    C2    C3    

A1   388   525   369   369   540   382   330   471   348   
     388   525   369   369   540   382   330   471   348   
     387   525   369   368   540   383   329   471   349   
     386   524   370   367   539   383   328   471   350   

bg   310   455   355   331   508   379   319   466   352   
     308   455   356   330   507   380   318   466   352   
     308   455   357   329   507   380   317   465   353   
     308   455   356   330   507   380   318   465   352   

A2   358   564   420   355   556   405   325   471   354   
     359   565   419   357   556   404   327   472   352   
     361   565   417   358   557   403   329   472   351   
     362   565   417   359   557   402   330   473   351   

bg   315   457   352   338   510   375   325   468   348   
     314   457   353   335   509   377   323   467   349   
     312   456   355   333   509   378   321   467   351   
     311   456   356   332   508   380   320   466   352   

A3   316   505   438   334   531   411   320   469   357   
     317   505   437   334   531   410   321   469   356   
     318   506   435   337   532   409   322   469   355   
     319   506   434   339   533   408   324   470   354   

bg   316   458   351   339   512   375   327   469   348   
     316   458   351   339   512   375   327   469   347   
     316   458   352   338   511   375   326   469   348   
     315   458   353   338   511   376   325   469   349   

B1   341   485   364   404   574   397   352   497   362   
     340   485   365   402   573   398   351   497   362   
     339   485   366   401   574   399   350   496   363   
     339   485   366   401   574   399   351   497   362   

bg   314   458   355   336   511   379   323   468   351   
     316   458   353   338   512   377   325   469   350   
     318   459   352   340   512   376   327   469   349   
     318   459   352   340   513   376   327   470   348   

B2   337   505   383   381   623   445   345   511   377   
     336   504   384   380   623   446   343   510   379   
     334   504   385   378   622   447   341   509   380   
     333   503   386   376   622   449   339   509   382   

bg   310   457   358   332   510   382   319   467   354   
     311   458   358   333   511   381   320   468   353   
     313   458   357   334   511   380   322   469   352   
     314   459   355   336   512   379   323   469   351   

B3   322   482   383   347   566   455   332   495   385   
     322   482   383   347   566   454   332   495   385   
     322   482   384   346   565   455   332   495   386   
     321   482   385   345   565   457   330   495   386   

bg   314   459   358   335   511   382   321   468   354   
     313   458   359   333   511   383   320   468   355   
     312   458   359   333   511   383   320   468   355   
     313   458   359   334   511   383   321   468   355   

C1   320   464   358   370   543   390   402   543   372   
     322   464   357   372   543   389   404   544   371   
     323   465   356   374   544   388   406   545   370   
     323   465   356   374   544   387   407   545   369   

bg   318   461   355   340   514   379   327   471   351   
     317   461   356   338   514   380   325   470   352   
     315   460   357   336   513   381   323   470   353   
     313   460   358   335   513   382   321   469   354   

C2   315   463   362   352   554   414   368   583   423   
     316   464   362   353   555   413   369   584   422   
     317   464   361   355   555   412   370   584   420   
     319   465   359   357   556   410   372   585   419   

bg   319   462   354   342   515   378   329   472   350   
     319   462   354   342   515   378   329   472   350   
     319   462   355   341   515   379   328   472   351   
     318   462   356   340   515   380   326   471   352   

C3   315   463   363   338   535   417   327   522   437   
     314   463   363   337   535   418   327   522   438   
     314   463   364   336   535   418   326   522   438   
     314   463   364   337   535   418   327   522   438   

bg   316   462   358   338   515   381   325   471   353   
     318   462   356   339   515   380   326   472   352   
     319   462   355   341   516   379   328   472   351   
     319   463   355   341   516   378   328   473   351   


