Trial #1-------------------------

     A1    A2    A3    B1    B2    B3    C1    C2    C3    

A1   383   522   368   363   536   381   324   467   346   
     382   522   369   362   536   381   324   467   346   
     381   521   369   361   536   382   323   467   347   
     380   521   370   361   535   379   322   467   348   

bg   309   454   352   330   505   375   317   463   347   
     309   453   352   330   506   375   317   463   347   
     309   454   352   330   506   374   318   463   346   
     310   454   352   331   506   374   318   463   346   

A2   357   563   417   353   553   401   324   469   348   
     357   563   417   353   553   400   324   469   348   
     358   563   416   354   554   401   324   469   348   
     357   562   417   353   553   391   324   469   348   

bg   310   454   352   331   507   375   319   464   346   
     310   454   353   331   506   375   318   464   347   
     310   454   353   330   507   376   318   464   347   
     310   454   353   330   507   376   317   464   348   

A3   318   504   432   335   529   404   320   467   350   
     318   504   431   336   530   404   321   467   350   
     319   504   431   337   530   403   322   468   350   
     320   505   430   337   530   394   322   468   349   

bg   313   456   351   334   508   374   321   465   345   
     313   456   351   333   508   374   321   465   346   
     312   456   352   333   508   375   320   465   346   
     311   455   353   332   508   376   319   465   347   

B1   339   484   362   402   572   394   350   494   357   
     340   484   362   402   572   393   350   495   357   
     340   484   362   403   572   393   351   494   357   
     341   484   361   404   573   388   351   495   356   

bg   314   456   352   335   509   374   322   466   346   
     314   457   352   335   509   374   322   466   346   
     314   457   352   335   509   374   322   466   346   
     314   457   352   335   509   375   322   466   346   

B2   332   502   383   375   620   444   339   507   376   
     331   502   383   374   620   445   337   506   376   
     331   501   384   374   619   445   337   506   377   
     331   502   384   374   620   435   337   506   377   

bg   312   457   354   332   509   376   320   466   348   
     312   457   353   333   509   375   320   466   347   
     313   457   353   334   510   375   321   467   346   
     313   457   353   335   510   375   322   467   346   

B3   317   479   383   341   562   455   326   491   383   
     317   479   384   340   562   456   325   491   384   
     316   479   385   340   562   457   324   491   384   
     315   479   386   339   562   458   324   491   385   

bg   311   457   355   332   509   378   319   466   349   
     312   457   355   332   510   377   319   466   349   
     312   457   355   333   510   377   320   467   349   
     313   458   354   334   510   377   321   467   348   

C1   318   462   355   368   541   386   401   541   367   
     318   462   355   368   541   386   401   541   367   
     318   462   355   368   541   386   401   541   367   
     318   462   355   368   541   387   399   541   367   

bg   313   458   355   334   511   378   321   467   349   
     312   458   356   333   511   379   320   467   349   
     312   458   356   333   510   379   320   467   350   
     312   458   356   333   510   378   320   467   350   

C2   316   463   358   353   553   407   368   581   416   
     316   463   358   354   553   406   369   581   415   
     317   463   357   355   553   406   370   582   414   
     317   463   357   355   554   406   370   582   414   

bg   315   459   354   337   512   377   323   468   348   
     315   459   355   336   512   378   323   468   348   
     314   459   355   335   512   378   322   468   349   
     314   459   356   335   512   387   321   468   350   

C3   314   462   360   337   533   412   327   520   431   
     315   462   360   338   533   412   327   520   431   
     315   462   359   338   533   412   328   520   430   
     316   462   359   339   534   411   328   521   430   

bg   316   460   355   337   513   377   324   470   348   
     316   460   355   338   513   377   324   470   348   
     316   460   355   338   513   377   324   469   349   
     316   460   355   338   513   378   324   469   349   


