Trial #1-------------------------

     A1    A2    A3    B1    B2    B3    C1    C2    C3    

A1   425   584   416   405   602   431   362   523   390   
     425   584   416   405   602   431   362   523   391   
     425   584   416   405   603   431   362   523   390   
     425   584   416   405   602   432   362   523   391   

bg   354   517   399   376   574   424   358   519   389   
     354   517   399   376   573   423   358   519   389   
     353   517   399   376   574   424   358   519   389   
     354   517   399   376   574   424   358   519   389   

A2   398   625   465   395   619   451   361   524   392   
     398   625   465   395   619   451   361   524   392   
     398   626   465   395   619   451   361   524   392   
     398   625   465   395   619   451   361   524   392   

bg   353   517   399   376   573   424   358   519   389   
     354   517   399   376   573   423   358   519   388   
     354   517   399   376   573   424   358   519   389   
     354   517   399   376   574   424   358   519   388   

A3   360   566   479   379   595   453   359   522   393   
     360   566   479   379   596   453   359   522   392   
     360   566   478   379   595   453   359   522   392   
     360   566   478   379   596   453   359   522   393   

bg   353   517   399   376   574   424   358   519   388   
     353   517   399   376   574   424   358   519   389   
     354   517   399   376   573   424   358   519   389   
     353   517   399   376   574   424   358   519   389   

B1   382   545   407   447   638   440   390   549   397   
     382   545   407   448   638   440   390   549   397   
     382   545   407   447   638   440   390   549   397   
     382   545   407   447   638   440   390   549   397   

bg   353   517   399   376   574   423   358   519   389   
     353   517   399   375   573   424   358   519   389   
     353   517   399   376   573   423   358   519   389   
     354   517   399   375   573   423   358   519   388   

B2   373   562   427   418   685   491   377   560   417   
     373   562   427   418   685   491   377   560   416   
     374   562   427   418   685   491   376   560   416   
     373   562   427   418   684   491   376   560   416   

bg   354   517   399   376   573   423   358   519   389   
     354   517   399   376   573   423   358   519   389   
     354   517   399   376   574   423   358   519   389   
     354   517   399   376   574   424   358   519   388   

B3   357   538   429   382   625   503   362   543   425   
     357   538   429   381   625   503   362   543   425   
     357   538   429   382   625   502   362   543   425   
     357   538   429   382   625   503   362   543   425   

bg   354   517   399   376   573   423   358   519   388   
     353   517   399   376   573   424   358   519   389   
     353   517   399   376   573   423   358   519   389   
     354   517   399   376   573   423   358   519   389   

C1   357   520   400   407   603   434   435   592   408   
     357   520   400   407   603   433   435   592   408   
     357   520   401   407   603   434   435   592   408   
     357   520   401   407   603   434   435   592   408   

bg   354   517   399   376   574   424   358   519   389   
     354   517   399   376   573   424   358   519   389   
     354   517   399   376   573   424   358   519   389   
     354   517   399   376   573   423   358   519   388   

C2   356   521   401   393   613   451   402   628   452   
     356   520   401   393   613   452   403   628   452   
     356   520   401   393   613   452   403   629   452   
     356   520   401   393   613   452   403   629   452   

bg   353   517   398   376   573   424   358   519   389   
     354   517   399   376   573   423   358   519   389   
     353   517   399   376   574   424   358   519   389   
     354   517   399   376   573   423   358   519   388   

C3   355   519   402   379   595   456   364   570   468   
     355   519   402   379   595   456   364   570   468   
     355   519   402   379   595   456   364   570   468   
     355   520   402   379   595   456   364   570   468   

bg   354   517   399   376   573   424   358   519   388   
     353   517   399   375   574   424   358   519   388   
     354   517   399   376   573   423   358   519   389   
     354   517   399   376   573   423   358   519   389   


