Trial #1-------------------------

     A1    A2    A3    B1    B2    B3    C1    C2    C3    

A1   77    72    19    31    31    9     4     4     2     
     77    72    19    31    31    9     4     4     2     
     77    72    19    31    31    9     4     4     2     
     77    72    19    31    31    9     4     4     2     

bg   0     0     0     0     0     0     0     0     0     
     0     0     0     0     0     0     0     0     0     
     0     0     0     0     0     0     0     0     0     
     0     0     0     0     0     0     0     0     0     

A2   46    114   70    20    48    29    3     5     4     
     46    114   70    20    48    29    3     5     4     
     46    114   70    20    48    29    3     5     4     
     46    114   69    20    47    29    3     5     4     

bg   0     0     0     0     0     0     0     0     0     
     0     0     0     0     0     0     0     0     0     
     0     0     0     0     0     0     0     0     0     
     0     0     0     0     0     0     0     0     0     

A3   7     52    85    3     23    32    2     3     4     
     7     52    85    3     23    32    2     3     4     
     7     52    85    3     23    32    2     3     4     
     7     52    85    3     23    32    2     3     4     

bg   0     0     0     0     0     0     0     0     0     
     0     0     0     0     0     0     0     0     0     
     0     0     0     0     0     0     0     0     0     
     0     0     0     0     0     0     0     0     0     

B1   31    30    8     76    68    18    34    31    9     
     31    30    8     76    68    18    33    30    9     
     31    30    8     76    68    17    33    30    9     
     31    29    8     75    68    17    33    30    9     

bg   0     0     0     0     0     0     0     0     0     
     0     0     0     0     0     0     0     0     0     
     0     0     0     0     0     0     0     0     0     
     0     0     0     0     0     0     0     0     0     

B2   21    47    31    44    119   72    19    42    29    
     21    47    31    44    118   72    19    42    29    
     21    47    31    44    118   72    19    42    29    
     21    47    31    44    118   72    19    42    29    

bg   0     0     0     0     0     0     0     0     0     
     0     0     0     0     0     0     0     0     0     
     0     0     0     0     0     0     0     0     0     
     0     0     0     0     0     0     0     0     0     

B3   4     24    34    6     57    87    4     26    40    
     4     24    34    6     57    87    4     26    40    
     4     24    34    6     57    87    4     26    40    
     4     24    34    6     57    87    4     26    40    

bg   0     0     0     0     0     0     0     0     0     
     0     0     0     0     0     0     0     0     0     
     0     0     0     0     0     0     0     0     0     
     0     0     0     0     0     0     0     0     0     

C1   3     4     2     33    30    11    82    77    20    
     3     4     2     33    30    11    82    77    20    
     3     4     2     33    31    11    82    77    20    
     3     4     2     33    31    11    82    77    20    

bg   0     0     0     0     0     0     0     0     0     
     0     0     0     0     0     0     0     0     0     
     0     0     0     0     0     0     0     0     0     
     0     0     0     0     0     0     0     0     0     

C2   3     4     3     20    45    32    52    125   73    
     3     4     3     20    45    32    52    125   73    
     3     4     3     20    45    32    52    125   73    
     3     4     3     20    45    32    52    125   73    

bg   0     0     0     0     0     0     0     0     0     
     0     0     0     0     0     0     0     0     0     
     0     0     0     0     0     0     0     0     0     
     0     0     0     0     0     0     0     0     0     

C3   1     3     4     3     22    35    6     54    86    
     1     3     4     3     22    35    6     54    86    
     1     3     4     3     22    35    6     54    86    
     1     3     4     3     22    35    6     54    86    

bg   0     0     0     0     0     0     0     0     0     
     0     0     0     0     0     0     0     0     0     
     0     0     0     0     0     0     0     0     0     
     0     0     0     0     0     0     0     0     0     


Trial #2-------------------------

     A1    A2    A3    B1    B2    B3    C1    C2    C3    

A1   77    72    19    31    31    9     4     4     2     
     77    72    19    31    31    9     4     4     2     
     76    71    19    31    30    9     4     4     2     
     76    71    18    31    30    9     4     4     2     

bg   0     0     0     0     0     0     0     0     0     
     0     0     0     0     0     0     0     0     0     
     0     0     0     0     0     0     0     0     0     
     0     0     0     0     0     0     0     0     0     

A2   47    114   70    20    48    30    3     5     4     
     47    114   70    20    48    30    3     5     4     
     47    114   70    20    48    29    3     5     4     
     46    114   70    20    48    29    3     5     4     

bg   0     0     0     0     0     0     0     0     0     
     0     0     0     0     0     0     0     0     0     
     0     0     0     0     0     0     0     0     0     
     0     0     0     0     0     0     0     0     0     

A3   7     52    85    3     23    32    2     3     4     
     7     52    85    3     23    32    2     3     4     
     7     52    85    3     23    32    2     3     4     
     7     52    84    3     23    31    2     3     4     

bg   0     0     0     0     0     0     0     0     0     
     0     0     0     0     0     0     0     0     0     
     0     0     0     0     0     0     0     0     0     
     0     0     0     0     0     0     0     0     0     

B1   30    29    8     75    67    17    33    30    9     
     30    29    8     75    67    17    33    30    9     
     30    29    8     75    67    17    33    30    9     
     30    29    8     75    67    17    33    30    9     

bg   0     0     0     0     0     0     0     0     0     
     0     0     0     0     0     0     0     0     0     
     0     0     0     0     0     0     0     0     0     
     0     0     0     0     0     0     0     0     0     

B2   21    47    31    44    119   72    19    42    29    
     21    47    31    44    118   72    19    42    29    
     21    48    31    44    118   72    19    42    29    
     21    47    31    44    118   72    19    42    29    

bg   0     0     0     0     0     0     0     0     0     
     0     0     0     0     0     0     0     0     0     
     0     0     0     0     0     0     0     0     0     
     0     0     0     0     0     0     0     0     0     

B3   4     24    34    6     57    87    4     26    40    
     4     24    34    6     57    87    4     26    40    
     4     24    34    6     57    87    4     26    40    
     4     24    34    6     57    87    4     26    40    

bg   0     0     0     0     0     0     0     0     0     
     0     0     0     0     0     0     0     0     0     
     0     0     0     0     0     0     0     0     0     
     0     0     0     0     0     0     0     0     0     

C1   3     4     2     33    31    11    82    77    20    
     3     4     2     33    31    11    82    77    20    
     3     4     2     33    31    11    82    77    20    
     3     4     2     33    31    11    82    77    20    

bg   0     0     0     0     0     0     0     0     0     
     0     0     0     0     0     0     0     0     0     
     0     0     0     0     0     0     0     0     0     
     0     0     0     0     0     0     0     0     0     

C2   2     4     3     20    45    32    51    124   73    
     2     4     3     20    45    32    51    124   73    
     2     4     3     20    45    32    51    124   72    
     2     4     3     20    45    32    51    124   72    

bg   0     0     0     0     0     0     0     0     0     
     0     0     0     0     0     0     0     0     0     
     0     0     0     0     0     0     0     0     0     
     0     0     0     0     0     0     0     0     0     

C3   1     3     4     3     22    35    6     54    87    
     1     3     4     3     22    35    6     54    87    
     1     3     4     3     22    35    6     54    87    
     1     3     4     3     22    35    6     54    87    

bg   0     0     0     0     0     0     0     0     0     
     0     0     0     0     0     0     0     0     0     
     0     0     0     0     0     0     0     0     0     
     0     0     0     0     0     0     0     0     0     


Trial #3-------------------------

     A1    A2    A3    B1    B2    B3    C1    C2    C3    

A1   77    72    19    31    31    9     4     4     2     
     77    72    19    31    31    9     4     4     2     
     76    72    19    31    30    9     4     4     2     
     76    71    19    31    30    9     4     4     2     

bg   0     0     0     0     0     0     0     0     0     
     0     0     0     0     0     0     0     0     0     
     0     0     0     0     0     0     0     0     0     
     0     0     0     0     0     0     0     0     0     

A2   47    114   70    20    48    30    3     5     4     
     47    114   70    20    48    30    3     5     4     
     47    114   70    20    48    30    3     5     4     
     47    114   70    20    48    30    3     5     4     

bg   0     0     0     0     0     0     0     0     0     
     0     0     0     0     0     0     0     0     0     
     0     0     0     0     0     0     0     0     0     
     0     0     0     0     0     0     0     0     0     

A3   7     52    85    3     23    32    2     3     4     
     7     52    85    3     23    32    2     3     4     
     7     52    84    3     23    31    2     3     4     
     7     52    84    3     23    31    2     3     4     

bg   0     0     0     0     0     0     0     0     0     
     0     0     0     0     0     0     0     0     0     
     0     0     0     0     0     0     0     0     0     
     0     0     0     0     0     0     0     0     0     

B1   30    29    8     75    68    17    33    30    9     
     30    29    8     75    68    17    33    30    9     
     30    29    8     75    67    17    33    30    9     
     30    29    8     75    67    17    33    30    9     

bg   0     0     0     0     0     0     0     0     0     
     0     0     0     0     0     0     0     0     0     
     0     0     0     0     0     0     0     0     0     
     0     0     0     0     0     0     0     0     0     

B2   21    48    31    44    119   72    19    42    29    
     21    48    31    44    119   72    19    42    29    
     21    48    31    44    118   72    19    42    29    
     21    48    31    44    118   72    19    42    29    

bg   0     0     0     0     0     0     0     0     0     
     0     0     0     0     0     0     0     0     0     
     0     0     0     0     0     0     0     0     0     
     0     0     0     0     0     0     0     0     0     

B3   4     24    34    6     57    87    4     26    40    
     4     24    34    6     57    87    4     26    40    
     4     24    34    6     57    87    4     26    40    
     4     24    34    6     57    87    4     26    40    

bg   0     0     0     0     0     0     0     0     0     
     0     0     0     0     0     0     0     0     0     
     0     0     0     0     0     0     0     0     0     
     0     0     0     0     0     0     0     0     0     

C1   3     4     2     33    31    11    83    78    20    
     4     4     2     33    31    11    83    78    20    
     3     4     2     33    31    11    82    77    20    
     3     4     2     33    31    11    82    77    20    

bg   0     0     0     0     0     0     0     0     0     
     0     0     0     0     0     0     0     0     0     
     0     0     0     0     0     0     0     0     0     
     0     0     0     0     0     0     0     0     0     

C2   3     4     3     20    45    32    51    125   73    
     3     4     3     20    45    32    51    125   73    
     3     4     3     20    45    32    51    124   73    
     3     4     3     20    45    32    51    124   73    

bg   0     0     0     0     0     0     0     0     0     
     0     0     0     0     0     0     0     0     0     
     0     0     0     0     0     0     0     0     0     
     0     0     0     0     0     0     0     0     0     

C3   1     3     4     3     22    35    6     54    86    
     1     3     4     3     22    35    6     54    86    
     1     3     4     3     22    35    6     54    86    
     1     3     4     3     22    35    6     54    86    

bg   0     0     0     0     0     0     0     0     0     
     0     0     0     0     0     0     0     0     0     
     0     0     0     0     0     0     0     0     0     
     0     0     0     0     0     0     0     0     0     


Trial #4-------------------------

     A1    A2    A3    B1    B2    B3    C1    C2    C3    

A1   77    72    19    31    31    9     4     4     2     
     76    72    19    31    31    9     4     4     2     
     76    72    19    31    31    9     4     4     2     
     76    72    19    31    30    9     4     4     2     

bg   0     0     0     0     0     0     0     0     0     
     0     0     0     0     0     0     0     0     0     
     0     0     0     0     0     0     0     0     0     
     0     0     0     0     0     0     0     0     0     

A2   47    115   70    20    48    30    3     5     4     
     47    114   70    20    48    30    3     5     4     
     47    114   70    20    48    30    3     5     4     
     47    114   70    20    48    30    3     5     4     

bg   0     0     0     0     0     0     0     0     0     
     0     0     0     0     0     0     0     0     0     
     0     0     0     0     0     0     0     0     0     
     0     0     0     0     0     0     0     0     0     

A3   7     52    85    3     23    32    2     3     4     
     7     52    85    3     23    32    2     3     4     
     7     52    84    3     23    32    2     3     4     
     7     52    84    3     23    32    2     3     4     

bg   0     0     0     0     0     0     0     0     0     
     0     0     0     0     0     0     0     0     0     
     0     0     0     0     0     0     0     0     0     
     0     0     0     0     0     0     0     0     0     

B1   31    29    8     76    68    17    33    30    9     
     31    29    8     76    68    17    33    30    9     
     31    29    8     76    68    17    33    30    9     
     31    29    8     75    68    17    33    30    9     

bg   0     0     0     0     0     0     0     0     0     
     0     0     0     0     0     0     0     0     0     
     0     0     0     0     0     0     0     0     0     
     0     0     0     0     0     0     0     0     0     

B2   21    47    30    44    118   72    19    42    29    
     21    47    30    44    118   72    19    42    29    
     21    47    30    43    118   72    19    42    29    
     21    47    30    43    118   72    19    42    29    

bg   0     0     0     0     0     0     0     0     0     
     0     0     0     0     0     0     0     0     0     
     0     0     0     0     0     0     0     0     0     
     0     0     0     0     0     0     0     0     0     

B3   4     24    34    6     57    87    4     26    40    
     4     24    34    6     57    87    4     26    40    
     4     24    34    6     57    87    4     26    40    
     4     24    34    6     57    87    4     26    40    

bg   0     0     0     0     0     0     0     0     0     
     0     0     0     0     0     0     0     0     0     
     0     0     0     0     0     0     0     0     0     
     0     0     0     0     0     0     0     0     0     

C1   3     4     2     33    30    11    82    77    20    
     3     4     2     33    30    11    82    77    20    
     3     4     2     33    30    11    81    77    20    
     3     4     2     33    30    11    81    77    20    

bg   0     0     0     0     0     0     0     0     0     
     0     0     0     0     0     0     0     0     0     
     0     0     0     0     0     0     0     0     0     
     0     0     0     0     0     0     0     0     0     

C2   3     4     3     20    45    32    51    125   73    
     3     4     3     20    45    32    51    125   73    
     3     4     3     20    45    32    51    125   73    
     3     4     3     20    45    32    51    125   73    

bg   0     0     0     0     0     0     0     0     0     
     0     0     0     0     0     0     0     0     0     
     0     0     0     0     0     0     0     0     0     
     0     0     0     0     0     0     0     0     0     

C3   1     3     4     3     22    35    6     54    86    
     1     3     4     3     22    35    6     54    86    
     1     3     4     3     22    35    6     54    86    
     1     3     4     3     22    35    6     54    86    

bg   0     0     0     0     0     0     0     0     0     
     0     0     0     0     0     0     0     0     0     
     0     0     0     0     0     0     0     0     0     
     0     0     0     0     0     0     0     0     0     


