Trial #1-------------------------

     A1    A2    A3    B1    B2    B3    C1    C2    C3    

A1   71    68    19    30    30    9     4     4     2     
     71    68    19    30    30    9     4     4     2     
     71    68    19    30    30    9     4     4     2     
     71    68    19    30    30    9     4     4     2     

bg   0     0     0     0     0     0     0     0     0     
     0     0     0     0     0     0     0     0     0     
     0     0     0     0     0     0     0     0     0     
     0     0     0     0     0     0     0     0     0     

A2   45    108   67    20    47    28    3     5     4     
     45    108   67    20    47    28    3     5     4     
     45    108   67    20    47    28    3     5     4     
     45    108   67    20    47    28    3     5     4     

bg   0     0     0     0     0     0     0     0     0     
     0     0     0     0     0     0     0     0     0     
     0     0     0     0     0     0     0     0     0     
     0     0     0     0     0     0     0     0     0     

A3   7     49    79    4     22    30    1     3     4     
     7     49    79    4     22    30    1     3     4     
     7     49    79    4     22    30    1     3     4     
     7     49    79    4     22    30    1     3     4     

bg   0     0     0     0     0     0     0     0     0     
     0     0     0     0     0     0     0     0     0     
     0     0     0     0     0     0     0     0     0     
     0     0     0     0     0     0     0     0     0     

B1   29    29    8     71    64    17    32    30    9     
     29    29    8     71    64    17    32    30    9     
     29    29    9     71    64    17    32    30    9     
     29    29    9     71    64    17    32    30    9     

bg   0     0     0     0     0     0     0     0     0     
     0     0     0     0     0     0     0     0     0     
     0     0     0     0     0     0     0     0     0     
     0     0     0     0     0     0     0     0     0     

B2   20    45    29    43    111   68    19    41    28    
     20    46    29    43    111   67    19    41    28    
     20    45    29    43    110   67    19    41    28    
     20    45    29    43    110   67    19    41    28    

bg   0     0     0     0     0     0     0     0     0     
     0     0     0     0     0     0     0     0     0     
     0     0     0     0     0     0     0     0     0     
     0     0     0     0     0     0     0     0     0     

B3   4     22    31    6     52    79    4     24    36    
     4     22    31    6     52    79    4     24    36    
     4     22    31    6     52    79    4     24    36    
     4     22    31    6     52    79    4     24    36    

bg   0     0     0     0     0     0     0     0     0     
     0     0     0     0     0     0     0     0     0     
     0     0     0     0     0     0     0     0     0     
     0     0     0     0     0     0     0     0     0     

C1   4     4     2     32    30    11    77    73    20    
     4     4     2     32    30    11    77    73    20    
     4     4     2     32    30    11    77    73    20    
     4     4     2     32    30    11    77    73    20    

bg   0     0     0     0     0     0     0     0     0     
     0     0     0     0     0     0     0     0     0     
     0     0     0     0     0     0     0     0     0     
     0     0     0     0     0     0     0     0     0     

C2   2     4     3     19    42    30    48    114   67    
     2     4     3     19    42    30    48    114   67    
     2     4     3     19    42    30    47    114   67    
     2     4     3     19    42    30    47    114   67    

bg   0     0     0     0     0     0     0     0     0     
     0     0     0     0     0     0     0     0     0     
     0     0     0     0     0     0     0     0     0     
     0     0     0     0     0     0     0     0     0     

C3   1     3     4     3     22    33    6     52    79    
     1     3     4     3     22    33    6     52    79    
     1     3     4     3     22    33    6     52    79    
     1     3     4     3     22    33    6     52    80    

bg   0     0     0     0     0     0     0     0     0     
     0     0     0     0     0     0     0     0     0     
     0     0     0     0     0     0     0     0     0     
     0     0     0     0     0     0     0     0     0     


