Trial #1-------------------------

     A1    A2    A3    B1    B2    B3    C1    C2    C3    

A1   71    69    19    30    30    9     4     4     2     
     71    68    19    30    30    9     4     4     2     
     71    68    19    30    30    9     4     4     2     
     71    68    19    30    30    9     4     4     2     

bg   0     0     0     0     0     0     0     0     0     
     0     0     0     0     0     0     0     0     0     
     0     0     0     0     0     0     0     0     0     
     0     0     0     0     0     0     0     0     0     

A2   45    109   67    20    47    29    3     5     4     
     45    109   67    20    47    29    3     5     4     
     45    108   67    20    47    29    3     5     4     
     45    108   67    20    47    28    3     5     4     

bg   0     0     0     0     0     0     0     0     0     
     0     0     0     0     0     0     0     0     0     
     0     0     0     0     0     0     0     0     0     
     0     0     0     0     0     0     0     0     0     

A3   7     50    80    4     23    30    2     3     4     
     7     50    80    4     23    30    2     3     4     
     7     50    80    4     23    30    2     3     4     
     7     50    80    4     23    30    2     3     4     

bg   0     0     0     0     0     0     0     0     0     
     0     0     0     0     0     0     0     0     0     
     0     0     0     0     0     0     0     0     0     
     0     0     0     0     0     0     0     0     0     

B1   30    29    9     72    65    17    33    30    9     
     29    28    8     69    64    17    32    29    9     
     30    29    9     72    65    17    33    30    9     
     29    29    9     72    65    17    32    30    9     

bg   0     0     0     0     0     0     0     0     0     
     0     0     0     0     0     0     0     0     0     
     0     0     0     0     0     0     0     0     0     
     0     0     0     0     0     0     0     0     0     

B2   21    46    30    43    112   68    19    41    28    
     21    46    30    43    112   68    19    41    28    
     21    46    30    43    112   68    19    41    28    
     21    46    30    43    111   68    19    41    28    

bg   0     0     0     0     0     0     0     0     0     
     0     0     0     0     0     0     0     0     0     
     0     0     0     0     0     0     0     0     0     
     0     0     0     0     0     0     0     0     0     

B3   4     22    31    6     53    81    4     25    37    
     4     22    31    6     53    80    4     25    37    
     4     22    31    6     53    80    4     25    37    
     4     22    31    6     53    80    4     25    37    

bg   0     0     0     0     0     0     0     0     0     
     0     0     0     0     0     0     0     0     0     
     0     0     0     0     0     0     0     0     0     
     0     0     0     0     0     0     0     0     0     

C1   4     4     2     32    30    11    77    74    20    
     4     4     2     32    30    11    77    74    20    
     4     4     2     32    30    11    77    73    20    
     4     4     2     32    30    11    77    73    20    

bg   0     0     0     0     0     0     0     0     0     
     0     0     0     0     0     0     0     0     0     
     0     0     0     0     0     0     0     0     0     
     0     0     0     0     0     0     0     0     0     

C2   2     4     3     19    42    30    48    115   67    
     2     4     3     19    42    30    48    114   67    
     2     4     3     19    42    30    48    114   67    
     2     4     3     19    42    30    48    114   67    

bg   0     0     0     0     0     0     0     0     0     
     0     0     0     0     0     0     0     0     0     
     0     0     0     0     0     0     0     0     0     
     0     0     0     0     0     0     0     0     0     

C3   1     3     4     3     22    33    6     52    80    
     1     3     4     3     22    33    6     52    80    
     1     3     4     3     22    33    6     52    80    
     1     3     4     4     22    33    6     52    80    

bg   0     0     0     0     0     0     0     0     0     
     0     0     0     0     0     0     0     0     0     
     0     0     0     0     0     0     0     0     0     
     0     0     0     0     0     0     0     0     0     


