Trial #1-------------------------

     A1    A2    A3    B1    B2    B3    C1    C2    C3    

A1   72    68    18    30    29    8     4     3     2     
     72    68    18    29    29    8     4     3     2     
     72    68    18    29    29    8     4     3     2     
     71    68    18    29    29    8     4     3     2     

bg   0     0     0     0     0     0     0     0     0     
     0     0     0     0     0     0     0     0     0     
     0     0     0     0     0     0     0     0     0     
     0     0     0     0     0     0     0     0     0     

A2   45    108   66    19    46    28    3     5     4     
     45    108   66    19    46    28    3     5     4     
     45    108   66    19    46    28    3     5     4     
     45    108   66    19    46    28    3     5     4     

bg   0     0     0     0     0     0     0     0     0     
     0     0     0     0     0     0     0     0     0     
     0     0     0     0     0     0     0     0     0     
     0     0     0     0     0     0     0     0     0     

A3   7     49    80    3     22    30    1     3     4     
     7     49    80    3     22    30    1     3     4     
     7     49    80    3     22    30    1     3     4     
     7     49    80    3     22    30    1     3     4     

bg   0     0     0     0     0     0     0     0     0     
     0     0     0     0     0     0     0     0     0     
     0     0     0     0     0     0     0     0     0     
     0     0     0     0     0     0     0     0     0     

B1   29    29    8     72    65    17    32    30    9     
     29    29    8     72    65    17    32    30    9     
     29    28    8     72    65    17    32    30    9     
     29    28    8     72    65    17    32    30    9     

bg   0     0     0     0     0     0     0     0     0     
     0     0     0     0     0     0     0     0     0     
     0     0     0     0     0     0     0     0     0     
     0     0     0     0     0     0     0     0     0     

B2   20    45    29    42    111   67    18    40    28    
     20    45    29    42    110   67    18    40    28    
     20    45    29    42    110   67    18    40    28    
     20    45    29    42    110   67    18    40    28    

bg   0     0     0     0     0     0     0     0     0     
     0     0     0     0     0     0     0     0     0     
     0     0     0     0     0     0     0     0     0     
     0     0     0     0     0     0     0     0     0     

B3   3     21    31    6     51    79    4     24    36    
     3     21    31    6     51    79    4     24    36    
     3     21    31    6     51    79    4     24    36    
     3     21    31    6     51    79    4     24    36    

bg   0     0     0     0     0     0     0     0     0     
     0     0     0     0     0     0     0     0     0     
     0     0     0     0     0     0     0     0     0     
     0     0     0     0     0     0     0     0     0     

C1   3     4     2     32    29    10    77    73    20    
     3     4     2     32    29    10    77    73    20    
     3     4     2     32    29    10    77    73    20    
     3     4     2     32    29    10    77    73    20    

bg   0     0     0     0     0     0     0     0     0     
     0     0     0     0     0     0     0     0     0     
     0     0     0     0     0     0     0     0     0     
     0     0     0     0     0     0     0     0     0     

C2   2     4     3     17    39    28    44    107   62    
     2     4     3     18    39    28    45    109   63    
     2     4     3     18    40    28    45    109   64    
     2     4     3     18    40    28    45    109   64    

bg   0     0     0     0     0     0     0     0     0     
     0     0     0     0     0     0     0     0     0     
     0     0     0     0     0     0     0     0     0     
     0     0     0     0     0     0     0     0     0     

C3   1     3     4     3     21    33    6     51    79    
     1     3     4     3     21    33    6     51    79    
     1     3     4     3     21    33    6     51    79    
     1     3     4     3     21    33    6     51    79    

bg   0     0     0     0     0     0     0     0     0     
     0     0     0     0     0     0     0     0     0     
     0     0     0     0     0     0     0     0     0     
     0     0     0     0     0     0     0     0     0     


