Trial #1-------------------------

     A1    A2    A3    B1    B2    B3    C1    C2    C3    

A1   106   114   62    67    87    64    54    80    74    
     106   113   62    67    87    64    54    79    73    
     106   113   61    67    87    63    54    79    73    
     105   113   61    66    86    63    54    78    73    

bg   30    42    42    35    55    54    49    74    70    
     30    42    42    35    55    54    49    74    70    
     30    41    42    35    55    53    49    74    69    
     30    41    42    35    55    53    49    74    69    

A2   76    152   110   55    102   82    52    78    73    
     76    152   110   55    102   82    52    78    73    
     76    152   110   55    102   83    52    79    73    
     76    152   110   55    102   83    52    79    73    

bg   30    42    42    35    55    54    49    74    70    
     30    42    42    35    55    54    49    75    70    
     30    42    42    35    56    54    49    75    70    
     31    42    42    35    56    54    49    75    70    

A3   37    93    125   39    79    85    51    77    74    
     37    93    125   39    79    85    51    77    74    
     37    93    125   39    79    85    51    78    74    
     38    93    125   39    79    85    51    78    75    

bg   31    43    43    36    56    55    50    76    71    
     31    43    43    36    57    55    50    76    72    
     31    43    43    36    57    55    51    77    72    
     31    43    43    36    57    56    51    77    72    

B1   61    72    52    110   124   74    84    108   82    
     62    73    52    110   124   74    84    108   83    
     62    73    52    110   125   74    84    109   83    
     62    73    53    110   125   74    84    109   83    

bg   33    45    45    38    59    58    52    80    75    
     33    45    45    38    60    58    53    80    75    
     33    45    45    38    60    58    53    80    76    
     33    45    46    38    60    58    53    81    76    

B2   53    91    74    81    175   128   71    121   103   
     53    91    74    81    174   128   71    120   103   
     52    90    74    80    174   127   71    120   102   
     52    90    74    80    173   127   70    119   102   

bg   32    44    44    37    58    56    51    78    73    
     32    44    44    37    58    57    52    79    74    
     32    44    45    38    59    57    52    79    75    
     33    45    45    38    60    58    53    80    75    

B3   38    69    80    46    117   145   59    108   117   
     38    70    80    46    118   146   60    109   117   
     38    71    81    47    119   146   60    110   118   
     39    71    81    47    119   147   61    111   119   

bg   36    49    49    42    65    63    58    88    83    
     36    49    50    42    66    64    58    88    83    
     36    50    50    42    66    64    58    89    84    
     36    50    50    42    66    64    59    89    84    

C1   40    54    52    75    97    75    138   165   104   
     40    53    52    75    96    75    138   165   104   
     40    53    52    74    96    75    138   164   104   
     40    53    52    74    96    75    138   164   104   

bg   36    50    50    42    66    64    58    89    84    
     36    50    50    42    66    64    59    89    84    
     36    50    50    42    66    64    59    89    84    
     36    50    50    42    66    64    59    89    84    

C2   39    54    53    62    110   96    108   210   155   
     39    54    53    62    110   96    108   210   155   
     39    54    53    62    110   96    108   210   155   
     39    54    53    62    110   96    108   210   155   

bg   36    50    50    42    66    64    58    89    83    
     36    50    50    42    66    64    58    89    83    
     36    50    50    42    66    64    58    89    83    
     36    50    50    42    66    64    58    89    84    

C3   38    52    54    45    88    98    65    142   168   
     38    52    54    45    88    99    65    142   168   
     38    53    54    45    88    99    65    142   168   
     38    53    54    45    88    99    65    142   168   

bg   36    50    50    42    67    65    59    90    84    
     36    50    51    42    67    65    59    90    84    
     37    50    51    42    67    65    59    90    84    
     37    50    51    43    67    65    59    90    85    


Trial #2-------------------------

     A1    A2    A3    B1    B2    B3    C1    C2    C3    

A1   111   121   69    74    98    74    64    94    87    
     111   121   70    74    98    74    64    94    88    
     111   121   70    74    98    74    64    94    88    
     111   121   70    74    98    75    64    95    88    

bg   37    51    52    43    68    66    60    92    86    
     37    51    52    44    68    66    60    92    87    
     37    51    52    44    68    66    60    92    87    
     37    51    52    44    68    67    61    92    87    

A2   84    163   121   64    116   96    64    97    91    
     84    164   121   64    117   96    64    98    92    
     84    164   121   64    117   97    65    99    92    
     84    164   122   65    118   98    65    100   93    

bg   40    55    55    46    73    71    64    98    92    
     40    55    56    47    74    72    66    99    94    
     41    56    57    48    75    73    66    101   95    
     42    57    57    48    76    74    67    102   96    

A3   50    110   143   53    101   107   71    108   104   
     50    110   143   54    102   108   71    109   104   
     50    111   143   54    103   109   72    110   105   
     51    111   144   54    103   109   72    111   106   

bg   45    61    62    52    81    79    72    110   104   
     45    61    62    52    82    80    72    110   104   
     45    62    62    52    82    80    73    110   104   
     45    62    62    52    82    80    73    111   104   

B1   75    91    70    126   149   98    105   141   114   
     75    91    70    126   149   98    105   141   113   
     75    91    70    126   148   97    105   141   113   
     75    91    70    125   148   97    105   141   113   

bg   44    61    62    52    81    79    72    109   103   
     44    61    61    52    81    79    72    109   103   
     44    61    61    51    81    79    71    109   103   
     44    60    61    51    80    78    71    108   102   

B2   64    107   91    94    196   149   90    149   130   
     64    107   90    94    196   149   90    149   130   
     64    107   91    94    196   149   90    149   131   
     64    107   91    94    196   149   90    150   131   

bg   44    61    61    51    81    79    71    109   102   
     44    61    61    51    81    79    72    109   103   
     44    61    61    52    81    79    72    109   103   
     44    61    61    52    81    79    72    109   103   

B3   48    84    95    58    137   165   76    135   142   
     48    84    95    59    137   165   77    136   142   
     49    85    95    59    138   165   77    136   143   
     49    85    95    59    138   165   77    136   143   

bg   45    61    62    52    82    80    72    110   104   
     45    61    62    52    82    79    72    110   104   
     45    61    62    52    81    79    72    110   103   
     44    61    62    52    81    79    72    109   103   

C1   47    64    63    83    110   89    150   183   122   
     47    64    63    83    110   89    150   183   122   
     47    64    63    83    110   88    150   183   121   
     47    63    62    83    109   88    149   182   121   

bg   43    59    60    50    79    77    70    106   100   
     43    59    60    50    79    77    70    106   100   
     43    59    60    50    79    77    70    106   100   
     43    59    60    50    79    77    70    106   100   

C2   46    64    63    70    124   109   120   228   172   
     46    64    64    70    124   109   120   228   172   
     46    64    64    70    124   109   121   228   172   
     46    64    64    70    124   109   121   228   172   

bg   44    60    60    51    80    77    70    107   101   
     44    60    60    51    80    77    70    107   101   
     44    60    60    51    80    77    70    107   101   
     44    60    60    51    80    78    70    107   101   

C3   45    63    64    54    102   112   77    160   186   
     45    63    64    54    102   112   77    160   185   
     45    63    64    54    102   112   77    160   185   
     45    63    64    54    102   112   77    160   185   

bg   44    60    61    51    80    78    71    107   101   
     44    60    61    51    80    78    71    107   101   
     44    60    61    51    80    78    71    108   101   
     44    60    61    51    80    78    71    108   101   


Trial #3-------------------------

     A1    A2    A3    B1    B2    B3    C1    C2    C3    

A1   119   131   80    82    111   87    75    112   104   
     119   131   80    82    111   87    75    112   104   
     118   131   80    82    111   87    75    112   105   
     118   131   80    82    111   87    76    112   105   

bg   44    61    61    52    81    79    72    109   103   
     44    61    61    52    81    79    72    109   103   
     44    61    61    52    81    79    72    109   103   
     44    61    62    52    81    79    72    109   103   

A2   90    173   130   71    128   108   75    114   107   
     90    172   130   71    128   108   75    113   106   
     90    172   130   71    128   108   74    113   106   
     90    172   129   71    128   107   74    113   106   

bg   44    60    61    51    80    78    71    108   102   
     44    60    61    51    80    78    71    108   102   
     44    60    61    51    80    78    71    108   101   
     44    60    60    51    80    77    70    107   101   

A3   50    110   143   53    101   107   71    108   103   
     49    110   142   53    101   107   70    108   103   
     49    109   142   53    101   107   70    107   103   
     49    109   142   53    100   106   70    107   102   

bg   42    58    58    49    77    75    68    104   98    
     42    58    58    49    77    75    68    103   97    
     42    58    58    49    76    74    68    103   97    
     42    57    58    48    76    74    67    102   96    

B1   70    85    64    121   140   89    98    130   103   
     70    84    63    120   139   88    97    127   101   
     69    83    63    119   138   87    96    126   99    
     68    82    62    118   137   86    94    124   97    

bg   36    50    50    42    66    65    58    89    84    
     36    49    49    41    65    63    58    87    82    
     35    48    48    41    64    62    56    86    81    
     35    47    48    40    63    61    56    84    79    

B2   54    93    76    83    177   130   73    124   106   
     54    92    76    82    177   130   73    123   106   
     54    92    76    82    176   129   73    123   105   
     53    92    75    82    175   129   72    122   105   

bg   33    45    45    38    59    58    53    80    75    
     33    45    45    38    59    58    53    80    75    
     33    45    45    38    60    58    53    80    75    
     33    45    45    38    60    58    53    80    75    

B3   37    68    79    45    116   144   58    106   115   
     37    69    79    45    116   144   58    107   115   
     37    69    79    45    116   144   58    107   115   
     37    69    79    45    116   144   58    107   115   

bg   33    46    46    38    60    59    53    81    76    
     33    45    46    38    60    59    53    81    76    
     33    45    46    38    60    58    53    81    76    
     33    45    45    38    60    58    53    81    76    

C1   36    48    46    69    89    67    131   154   94    
     35    47    46    69    88    67    130   153   93    
     35    47    45    69    87    66    130   152   92    
     35    46    45    68    87    66    129   151   92    

bg   30    42    42    35    56    54    49    74    70    
     30    42    42    35    55    53    49    74    69    
     30    41    41    35    55    53    48    73    69    
     30    41    41    35    54    53    48    73    68    

C2   32    45    44    54    98    84    98    194   139   
     32    45    44    54    98    84    98    193   139   
     32    45    44    54    98    84    98    193   139   
     32    45    44    54    98    84    98    193   139   

bg   30    41    42    35    55    53    49    74    69    
     30    42    42    35    55    54    49    74    70    
     31    42    42    36    56    54    50    75    71    
     31    43    43    36    57    55    50    76    71    

C3   33    46    47    40    80    91    57    131   158   
     34    47    48    40    80    91    58    132   158   
     34    47    48    41    81    91    58    132   159   
     34    47    48    41    81    92    59    133   159   

bg   33    45    45    38    59    58    53    80    75    
     33    45    45    38    59    58    53    80    75    
     33    45    45    38    59    58    52    80    75    
     32    45    45    38    59    57    52    79    75    


Trial #4-------------------------

     A1    A2    A3    B1    B2    B3    C1    C2    C3    

A1   107   114   62    68    88    65    55    81    75    
     106   113   62    67    87    64    55    80    74    
     106   113   61    67    87    64    54    79    73    
     105   112   61    66    86    63    53    79    72    

bg   30    41    41    35    55    53    48    73    69    
     30    41    41    35    54    53    48    73    68    
     30    41    41    34    54    52    48    72    68    
     29    40    41    34    54    52    47    72    68    

A2   75    152   109   54    100   81    50    76    70    
     75    152   109   53    100   80    50    75    70    
     75    152   109   53    100   80    50    75    70    
     75    152   109   54    100   81    50    76    70    

bg   29    40    40    34    53    52    47    71    67    
     29    40    40    34    53    52    47    72    67    
     29    40    40    34    53    52    47    72    67    
     29    40    40    34    53    52    47    72    67    

A3   36    91    123   37    76    82    48    74    71    
     36    91    123   37    76    82    48    74    71    
     36    91    123   37    76    82    48    74    71    
     36    91    123   37    76    82    48    74    71    

bg   29    40    40    34    53    51    47    71    67    
     29    40    40    34    53    51    47    71    67    
     29    40    40    34    53    51    47    71    67    
     29    40    40    34    53    52    47    71    67    

B1   60    70    49    108   120   70    80    103   77    
     60    70    49    108   121   70    80    103   77    
     60    70    49    108   121   70    81    103   78    
     60    70    50    109   121   71    81    104   78    

bg   31    42    43    36    56    55    50    76    71    
     31    43    43    36    57    55    50    77    72    
     32    43    44    37    57    56    51    77    73    
     32    44    44    37    58    56    51    78    73    

B2   53    91    75    81    175   128   72    121   104   
     53    91    75    81    175   128   72    122   104   
     53    92    75    81    175   129   72    122   104   
     54    92    76    82    175   129   72    123   105   

bg   34    46    46    39    61    59    54    82    77    
     34    46    47    39    61    60    54    83    78    
     34    46    47    39    62    60    55    83    78    
     34    46    47    39    62    60    55    83    78    

B3   38    70    80    46    118   146   59    109   117   
     38    70    80    46    118   146   59    109   117   
     38    70    80    46    118   146   59    109   117   
     38    70    80    46    118   146   59    109   118   

bg   35    47    48    40    63    61    56    85    80    
     35    48    48    40    63    61    56    85    80    
     35    48    48    41    64    62    56    86    81    
     35    48    48    41    64    62    57    86    81    

C1   38    52    50    73    94    73    136   161   101   
     38    51    50    73    94    72    136   161   101   
     38    51    50    72    93    72    135   160   100   
     38    51    49    72    92    71    134   159   99    

bg   33    45    45    38    60    58    53    80    75    
     32    44    45    37    59    57    52    79    74    
     32    43    44    37    58    56    51    77    73    
     31    43    43    36    57    55    50    76    72    

C2   33    46    45    54    99    85    98    194   140   
     32    45    44    54    98    84    98    194   139   
     32    45    44    54    98    84    98    193   139   
     32    45    44    54    98    84    97    193   139   

bg   29    40    40    34    53    52    47    71    67    
     29    40    40    34    53    51    47    71    67    
     29    40    40    34    53    51    47    71    66    
     29    40    40    33    52    51    46    70    66    

C3   30    42    43    36    74    84    52    122   149   
     30    42    43    36    74    84    52    122   149   
     30    42    42    36    73    84    52    122   149   
     30    41    42    36    73    84    52    122   149   

bg   28    39    39    33    51    50    45    69    64    
     28    38    39    33    51    49    45    68    64    
     28    38    38    32    51    49    45    68    64    
     28    38    38    32    51    49    45    68    64    


