Trial #1-------------------------

     A1    A2    A3    B1    B2    B3    C1    C2    C3    

A1   96    100   49    56    70    47    39    56    52    
     96    100   49    56    70    47    39    56    52    
     96    100   49    56    70    47    39    56    52    
     96    100   49    56    70    47    39    56    52    

bg   21    30    30    25    39    39    35    53    50    
     21    30    30    25    39    38    35    53    50    
     21    30    30    25    39    38    35    53    50    
     21    30    30    25    39    38    35    53    50    

A2   67    141   99    45    86    68    38    57    53    
     67    141   99    45    87    68    38    57    54    
     67    141   99    45    87    68    38    58    54    
     67    141   99    45    87    68    38    58    54    

bg   22    30    31    25    40    39    36    54    51    
     21    30    31    25    40    39    36    54    50    
     21    30    30    25    40    39    35    53    50    
     21    30    30    25    39    39    35    53    50    

A3   28    81    113   28    62    69    36    55    54    
     28    81    113   28    62    70    36    56    54    
     28    81    114   28    62    70    36    56    54    
     28    81    114   28    63    70    36    56    54    

bg   21    30    30    25    40    39    35    53    50    
     21    30    30    25    40    39    35    53    50    
     21    30    30    25    40    39    35    53    50    
     21    30    30    25    40    39    35    53    50    

B1   51    59    39    99    106   56    68    83    59    
     51    59    39    99    106   56    68    83    59    
     51    59    39    99    106   56    68    83    59    
     51    59    38    99    106   56    68    83    59    

bg   21    29    30    25    39    38    35    53    50    
     21    29    30    25    39    38    35    52    49    
     21    29    30    25    39    38    35    52    49    
     21    29    30    25    39    38    35    52    49    

B2   42    76    60    68    155   109   54    94    78    
     42    76    60    68    155   109   54    94    78    
     42    76    60    68    155   109   54    94    78    
     42    76    60    68    155   109   54    94    78    

bg   21    30    30    25    39    39    35    53    50    
     21    30    30    25    39    39    35    53    50    
     21    30    30    25    39    39    35    53    50    
     21    30    30    25    40    39    35    53    50    

B3   25    53    64    31    96    124   39    79    89    
     25    53    64    32    95    124   39    79    89    
     25    53    63    32    95    124   39    78    89    
     25    53    63    32    95    123   39    78    89    

bg   21    30    30    25    39    39    35    53    50    
     21    30    30    25    39    39    35    53    50    
     21    30    30    25    39    39    35    53    50    
     21    30    30    25    39    39    35    53    50    

C1   24    33    32    57    70    49    114   128   70    
     24    33    32    57    70    49    114   128   70    
     25    33    32    57    70    49    115   128   70    
     25    33    32    57    70    49    115   128   70    

bg   21    30    30    25    39    39    35    53    50    
     21    30    30    25    39    39    35    53    50    
     21    30    30    25    39    39    35    53    50    
     21    30    30    25    39    39    35    53    50    

C2   24    34    33    45    84    70    85    175   121   
     24    34    33    45    84    70    85    174   121   
     24    34    33    44    84    70    85    174   121   
     24    34    33    44    84    70    85    174   121   

bg   21    30    30    25    39    39    35    53    50    
     21    30    30    25    39    39    35    53    50    
     21    30    30    25    39    39    35    53    50    
     21    30    30    25    39    39    35    53    50    

C3   23    32    34    28    61    73    41    106   134   
     22    32    34    28    61    73    41    106   134   
     22    32    34    28    61    73    41    106   134   
     22    32    34    28    61    73    41    106   134   

bg   21    29    30    25    39    38    35    53    50    
     21    29    30    25    39    38    35    53    50    
     21    29    30    25    39    38    35    53    50    
     21    29    30    25    39    38    35    53    50    


Trial #2-------------------------

     A1    A2    A3    B1    B2    B3    C1    C2    C3    

A1   96    100   49    55    70    47    39    56    52    
     96    100   49    55    70    47    39    56    52    
     95    100   49    55    70    47    39    56    52    
     95    99    49    55    69    47    39    56    52    

bg   21    29    30    25    39    39    35    53    50    
     21    29    30    25    39    38    35    53    50    
     21    29    30    25    39    38    35    53    50    
     21    29    30    25    39    38    35    52    50    

A2   67    141   99    44    86    68    38    57    53    
     67    141   99    44    86    68    38    57    53    
     67    141   99    44    86    67    38    57    53    
     67    141   98    44    86    67    38    57    53    

bg   21    29    30    25    39    39    35    53    50    
     21    29    30    25    39    39    35    53    50    
     21    29    30    25    39    38    35    53    50    
     21    29    30    25    39    38    35    53    50    

A3   28    81    114   28    62    70    36    55    54    
     28    81    114   28    62    69    36    55    54    
     28    81    113   28    62    69    36    55    54    
     28    80    113   28    62    69    36    55    54    

bg   21    29    30    25    39    38    35    53    49    
     21    29    30    25    39    38    35    53    49    
     21    29    30    25    39    38    35    53    49    
     21    29    30    25    39    38    35    53    49    

B1   51    58    38    98    105   56    67    83    58    
     51    58    38    98    105   56    67    82    58    
     51    58    38    97    105   56    67    82    58    
     51    58    38    97    105   56    67    82    58    

bg   21    29    30    25    39    38    35    53    50    
     21    29    30    25    39    38    35    53    50    
     21    29    30    25    39    38    35    53    50    
     21    30    30    25    39    38    35    53    50    

B2   42    76    60    68    155   109   54    94    78    
     42    76    60    68    155   109   54    94    78    
     42    76    60    68    155   109   54    94    78    
     42    76    60    68    155   109   54    94    78    

bg   21    29    30    25    39    38    35    53    50    
     21    29    30    25    39    38    35    53    50    
     21    29    30    25    39    38    35    53    50    
     21    29    30    25    39    38    35    53    50    

B3   25    53    63    31    95    124   39    78    88    
     25    53    63    31    95    123   39    78    88    
     25    53    63    31    95    123   39    78    88    
     25    53    63    31    95    123   39    78    88    

bg   21    30    30    25    39    38    35    53    50    
     21    30    30    25    39    39    35    53    50    
     21    30    30    25    39    39    35    53    50    
     21    30    30    25    39    39    35    53    50    

C1   24    33    32    57    70    49    114   128   70    
     24    33    32    57    70    49    114   128   70    
     24    33    32    57    70    49    114   128   70    
     24    33    32    57    70    49    114   128   70    

bg   21    30    30    25    39    39    35    53    50    
     21    30    30    25    39    39    35    53    50    
     21    30    30    25    39    39    35    53    50    
     21    30    30    25    39    39    35    53    50    

C2   24    34    33    45    84    71    85    175   122   
     24    34    33    45    84    71    85    175   122   
     24    34    33    45    84    71    85    175   122   
     24    34    33    45    84    71    85    175   122   

bg   21    30    30    25    40    39    35    53    50    
     21    30    30    25    40    39    35    53    50    
     21    30    30    25    40    39    35    53    50    
     21    30    30    25    40    39    35    53    50    

C3   23    33    34    28    62    74    41    107   135   
     23    33    34    28    62    74    41    107   135   
     23    32    34    28    62    74    41    107   135   
     23    32    34    28    62    74    41    106   135   

bg   21    30    30    25    40    39    35    53    50    
     21    30    31    25    40    39    35    53    50    
     21    30    31    25    40    39    35    53    50    
     22    30    31    25    40    39    35    53    50    


Trial #3-------------------------

     A1    A2    A3    B1    B2    B3    C1    C2    C3    

A1   97    101   49    56    70    48    39    57    52    
     96    100   49    56    70    48    39    57    52    
     96    100   49    56    70    48    39    57    52    
     95    100   49    56    70    48    39    57    52    

bg   21    30    30    25    40    39    35    53    50    
     21    30    30    25    40    39    35    53    50    
     21    30    30    25    40    39    35    53    50    
     21    30    30    25    40    39    35    53    50    

A2   68    142   99    45    87    68    38    58    54    
     68    142   99    45    87    68    38    58    54    
     68    142   99    45    87    68    38    58    54    
     68    142   99    45    87    68    38    58    54    

bg   21    30    31    25    40    39    35    53    50    
     21    30    31    25    40    39    35    53    50    
     21    30    30    25    40    39    35    53    50    
     21    30    30    25    40    39    35    53    50    

A3   28    81    114   28    63    70    36    56    54    
     28    81    114   28    63    70    36    56    54    
     28    81    113   28    63    70    36    56    54    
     28    81    113   28    63    70    36    56    54    

bg   21    30    30    25    40    39    35    53    50    
     21    30    31    25    40    39    35    53    50    
     21    30    31    25    40    39    35    53    50    
     21    30    31    25    40    39    35    53    50    

B1   51    59    39    98    106   56    67    83    59    
     51    59    39    98    106   56    67    83    59    
     51    59    39    98    106   56    67    83    59    
     51    59    39    98    106   56    67    83    59    

bg   21    30    30    25    40    39    35    53    50    
     21    30    30    25    40    39    35    53    50    
     21    30    30    25    40    39    35    53    50    
     21    30    30    25    40    39    35    53    50    

B2   42    76    60    68    155   110   54    95    79    
     42    76    60    68    155   110   54    95    79    
     42    76    60    68    155   110   54    95    79    
     42    76    60    68    155   109   54    95    79    

bg   21    30    30    25    40    39    35    53    50    
     21    30    30    25    40    39    35    53    50    
     21    30    30    25    40    39    35    53    50    
     21    30    30    25    40    39    35    53    50    

B3   25    53    64    32    96    124   40    79    89    
     25    53    64    32    96    124   40    79    89    
     25    53    64    32    96    124   39    79    89    
     25    53    64    32    96    124   39    79    89    

bg   21    30    30    25    39    39    35    53    50    
     21    30    30    25    39    39    35    53    50    
     21    30    30    25    39    39    35    53    50    
     21    30    30    25    39    39    35    53    50    

C1   25    33    32    58    70    49    115   129   70    
     25    33    32    58    70    49    115   129   70    
     25    33    32    58    70    49    115   129   70    
     25    33    32    58    70    49    115   129   70    

bg   21    30    30    25    40    39    35    53    50    
     21    30    30    25    40    39    35    53    50    
     21    30    30    25    39    39    35    53    50    
     21    30    30    25    39    39    35    53    50    

C2   24    34    33    45    84    70    85    174   121   
     24    34    33    45    84    70    85    174   121   
     24    34    33    45    84    70    85    174   121   
     24    34    33    45    84    71    85    174   121   

bg   21    30    31    25    40    39    35    53    50    
     21    30    30    25    40    39    35    53    50    
     21    30    30    25    40    39    35    53    50    
     21    30    30    25    39    39    35    53    50    

C3   23    32    34    28    61    73    41    106   135   
     23    32    34    28    61    73    41    106   135   
     23    32    34    28    61    73    41    106   134   
     23    32    34    28    61    73    41    106   134   

bg   21    30    30    25    40    39    35    53    50    
     21    30    30    25    40    39    35    53    50    
     21    30    30    25    39    39    35    53    50    
     21    30    30    25    39    39    35    53    50    


Trial #4-------------------------

     A1    A2    A3    B1    B2    B3    C1    C2    C3    

A1   96    100   49    55    70    47    39    56    52    
     95    100   49    55    70    47    39    56    52    
     95    100   49    55    70    47    39    56    52    
     95    100   49    55    69    47    39    56    52    

bg   21    30    30    25    39    38    35    53    50    
     21    30    30    25    39    38    35    53    50    
     21    30    30    25    39    39    35    53    50    
     21    30    30    25    39    39    35    53    50    

A2   67    142   99    45    87    68    38    57    53    
     67    142   99    45    87    68    38    57    53    
     67    142   99    45    87    68    38    57    53    
     68    142   99    45    87    68    38    58    54    

bg   22    30    31    25    40    39    36    54    51    
     22    31    31    26    41    40    36    55    51    
     22    31    31    26    41    40    36    55    51    
     22    30    31    26    40    40    36    54    51    

A3   28    81    114   28    63    70    37    56    54    
     28    81    114   28    63    70    36    56    54    
     28    81    114   28    63    70    36    56    54    
     28    81    113   28    63    70    36    56    54    

bg   21    30    30    25    39    39    35    53    50    
     21    30    30    25    39    39    35    53    50    
     21    30    30    25    39    39    35    53    50    
     21    30    30    25    39    39    35    53    50    

B1   51    59    38    99    106   56    67    83    59    
     51    59    39    99    106   56    68    83    59    
     51    59    39    99    106   56    68    83    59    
     51    59    39    99    106   56    68    83    59    

bg   22    30    31    25    40    39    35    54    50    
     22    30    31    25    40    39    35    54    50    
     22    30    31    25    40    39    35    53    50    
     21    30    31    25    40    39    35    53    50    

B2   42    76    60    68    156   110   54    95    79    
     42    76    60    68    155   110   54    95    79    
     42    76    60    68    155   109   54    95    79    
     42    76    60    68    155   109   54    94    79    

bg   21    29    30    25    39    38    35    53    49    
     21    29    30    25    39    38    35    53    49    
     21    29    30    25    39    38    35    53    49    
     21    30    30    25    39    38    35    53    50    

B3   25    53    64    31    96    125   39    79    89    
     25    53    64    31    96    125   39    79    89    
     25    53    64    31    96    124   39    79    89    
     25    53    64    31    96    124   39    79    89    

bg   21    30    30    25    39    39    35    53    50    
     21    30    30    25    39    39    35    53    50    
     21    30    30    25    39    39    35    53    50    
     21    30    30    25    40    39    35    53    50    

C1   25    34    33    58    70    50    116   130   71    
     25    34    33    58    70    50    115   129   71    
     25    33    32    57    70    50    115   129   70    
     25    33    32    57    70    49    115   129   70    

bg   21    30    30    25    39    39    35    53    50    
     21    30    30    25    39    39    35    53    50    
     21    30    30    25    39    39    35    53    50    
     21    30    30    25    39    39    35    53    50    

C2   24    34    33    45    84    70    85    174   121   
     24    34    33    45    84    70    85    174   121   
     24    34    33    45    84    70    85    174   121   
     24    34    33    45    84    70    85    174   121   

bg   21    30    30    25    39    39    35    53    50    
     21    30    30    25    39    39    35    53    50    
     21    30    30    25    39    39    35    53    50    
     21    30    30    25    39    39    35    53    50    

C3   23    32    34    28    61    73    41    106   134   
     23    32    34    28    61    73    41    106   134   
     23    32    34    28    61    73    41    106   134   
     23    32    34    28    61    73    41    106   134   

bg   21    30    30    25    39    39    35    53    50    
     21    30    30    25    39    39    35    53    50    
     21    30    30    25    39    39    35    53    50    
     21    30    30    25    39    39    35    53    50    


