Trial #1-------------------------

     A1    A2    A3    B1    B2    B3    C1    C2    C3    

A1   104   111   59    65    84    60    51    75    69    
     104   110   59    65    83    60    51    75    69    
     104   110   59    65    83    60    51    75    69    
     103   110   58    65    83    60    51    74    69    

bg   29    40    40    34    53    51    47    71    66    
     29    40    40    34    53    51    47    71    66    
     29    40    40    34    53    51    47    71    66    
     29    40    40    34    53    51    47    71    66    

A2   75    151   109   53    100   81    50    75    70    
     75    151   109   53    100   80    50    76    70    
     75    151   108   53    100   80    50    76    70    
     75    151   108   53    100   80    50    76    70    

bg   29    40    40    34    53    51    47    71    67    
     29    40    40    34    53    52    47    71    67    
     29    40    40    34    53    52    48    71    67    
     29    40    40    34    53    52    48    72    67    

A3   36    91    124   38    77    83    49    75    72    
     36    91    124   38    77    83    49    75    72    
     36    91    124   37    77    83    49    74    72    
     36    91    124   37    76    83    49    74    71    

bg   29    40    40    34    53    52    47    71    67    
     29    40    40    34    53    52    47    71    67    
     29    40    40    34    53    52    48    72    67    
     29    40    40    34    53    52    48    72    67    

B1   59    69    48    108   120   69    80    102   76    
     59    69    48    108   120   69    80    102   76    
     59    69    48    108   120   69    80    102   76    
     59    69    48    107   120   69    80    102   76    

bg   29    40    40    34    53    52    48    72    67    
     29    40    40    34    53    52    48    72    67    
     29    40    40    34    54    52    48    72    67    
     29    40    40    34    54    52    48    72    67    

B2   50    87    70    78    170   123   67    114   96    
     50    87    70    78    170   123   67    114   96    
     50    87    70    78    169   123   67    114   96    
     50    87    70    78    169   123   67    114   96    

bg   29    40    40    34    54    52    48    72    68    
     29    40    40    34    54    52    48    72    68    
     29    40    41    34    54    52    48    72    68    
     29    40    41    34    54    52    48    72    68    

B3   33    64    74    41    110   138   52    98    107   
     33    64    74    41    110   138   52    98    107   
     33    64    74    41    110   137   52    98    107   
     33    64    74    41    110   137   53    98    107   

bg   30    41    41    35    54    52    48    73    68    
     30    41    41    35    54    52    48    73    68    
     30    41    41    35    54    52    48    73    68    
     29    41    41    35    54    52    48    73    68    

C1   33    44    43    67    85    63    128   149   89    
     33    45    43    67    85    63    128   149   89    
     33    45    43    67    85    63    128   149   89    
     33    45    43    67    85    64    128   149   89    

bg   30    41    41    35    55    53    49    74    69    
     30    41    41    35    55    53    49    74    69    
     30    41    41    35    55    53    49    74    69    
     30    41    41    35    55    53    49    74    69    

C2   32    45    44    54    99    85    99    195   140   
     32    45    44    54    99    85    99    195   140   
     32    45    44    54    99    85    99    195   140   
     32    45    44    54    99    85    99    195   140   

bg   30    41    41    35    54    53    48    73    68    
     30    41    41    35    54    53    48    73    68    
     30    41    41    35    54    53    48    73    68    
     30    41    41    35    54    53    48    73    68    

C3   31    43    44    38    76    87    54    126   153   
     31    43    44    38    76    87    54    126   153   
     31    43    44    38    76    87    54    126   153   
     31    43    44    38    76    87    54    126   153   

bg   30    41    41    35    54    53    48    73    68    
     30    41    41    35    54    53    48    73    68    
     30    41    41    35    54    53    48    73    68    
     30    41    41    35    54    53    48    73    68    


Trial #2-------------------------

     A1    A2    A3    B1    B2    B3    C1    C2    C3    

A1   105   112   60    66    85    62    53    77    70    
     105   112   60    66    85    62    53    77    70    
     105   112   60    66    85    62    53    77    70    
     104   111   60    66    85    62    53    76    70    

bg   30    41    41    35    54    53    49    73    69    
     30    41    41    35    55    53    49    73    69    
     30    41    41    35    55    53    49    73    69    
     30    41    41    35    55    53    49    73    69    

A2   76    153   110   55    102   82    52    78    73    
     76    153   110   55    102   82    52    78    73    
     76    153   110   55    102   82    52    78    73    
     76    153   110   55    102   82    52    79    73    

bg   30    42    42    35    55    54    49    74    70    
     30    42    42    35    55    54    49    74    70    
     30    42    42    35    56    54    50    75    70    
     30    42    42    36    56    54    50    75    70    

A3   37    93    125   39    79    85    51    78    75    
     37    93    125   39    79    85    51    78    75    
     37    93    125   39    79    86    52    78    75    
     38    93    125   39    80    86    52    79    75    

bg   31    43    43    37    57    56    51    77    72    
     31    43    43    37    58    56    51    77    73    
     32    43    44    37    58    56    52    78    73    
     32    44    44    37    58    56    52    78    73    

B1   62    73    53    111   126   75    85    110   83    
     62    74    53    112   126   75    86    111   84    
     63    74    54    112   127   76    86    111   85    
     63    74    54    112   127   76    86    111   85    

bg   33    46    46    39    61    59    54    82    77    
     33    46    46    39    61    59    55    82    77    
     33    46    46    39    61    60    55    83    77    
     34    46    46    40    62    60    55    83    78    

B2   55    94    77    84    179   132   75    127   108   
     55    94    78    84    179   132   76    127   109   
     55    94    78    84    179   133   76    127   109   
     55    94    78    84    179   132   76    127   109   

bg   35    48    48    41    64    62    57    86    81    
     35    48    48    41    64    63    57    87    81    
     35    49    49    41    65    63    58    87    82    
     35    49    49    42    65    63    58    88    82    

B3   40    73    83    49    122   149   63    114   122   
     40    73    83    49    122   149   64    115   122   
     40    73    83    49    123   150   64    115   123   
     40    73    83    49    123   150   64    116   123   

bg   37    51    51    43    68    66    60    91    85    
     37    51    51    43    68    66    61    91    86    
     37    51    51    43    68    66    61    92    86    
     37    51    52    44    68    67    61    92    86    

C1   41    55    54    77    99    78    142   169   107   
     41    56    54    77    100   78    142   169   108   
     41    56    54    77    100   78    142   169   108   
     41    56    54    77    100   78    142   170   108   

bg   38    53    53    45    71    69    63    95    89    
     38    53    53    45    71    69    63    95    89    
     38    53    53    45    71    69    63    95    89    
     38    53    53    45    71    69    63    95    89    

C2   41    57    56    64    115   100   113   216   160   
     41    57    56    64    115   100   113   216   160   
     41    57    56    65    115   100   113   216   160   
     41    57    56    65    115   100   113   216   160   

bg   39    53    54    45    71    69    64    96    90    
     39    53    54    46    71    69    64    96    90    
     39    53    54    46    71    69    64    96    90    
     39    54    54    46    71    69    64    96    90    

C3   40    56    57    49    93    104   70    149   175   
     40    56    58    49    93    104   70    149   175   
     40    56    58    49    94    104   70    149   175   
     41    57    58    49    94    104   70    150   175   

bg   39    54    54    46    72    70    64    97    91    
     39    54    54    46    72    70    64    97    91    
     39    54    54    46    72    70    65    97    91    
     39    54    55    46    72    70    65    97    92    


Trial #3-------------------------

     A1    A2    A3    B1    B2    B3    C1    C2    C3    

A1   114   125   73    77    103   79    69    101   94    
     114   125   73    77    103   79    69    101   94    
     114   124   73    77    103   79    69    101   94    
     113   124   73    77    103   79    69    101   94    

bg   39    54    55    46    73    71    65    98    92    
     39    54    55    46    73    71    65    98    92    
     40    54    55    46    73    71    65    98    92    
     40    54    55    46    73    71    65    98    92    

A2   86    167   124   66    120   100   68    102   96    
     86    167   124   66    120   100   68    102   96    
     86    166   123   66    120   100   68    102   96    
     86    166   123   66    120   100   68    102   96    

bg   39    54    55    46    73    71    65    98    92    
     39    54    55    46    73    71    65    98    92    
     40    55    55    46    73    71    65    98    92    
     40    55    55    47    73    71    65    99    93    

A3   46    106   138   50    96    102   66    101   96    
     46    105   138   50    96    101   66    100   96    
     46    105   137   49    95    101   66    100   95    
     46    105   137   49    95    101   66    100   95    

bg   39    54    54    46    71    70    64    96    90    
     39    54    54    46    71    69    64    96    90    
     39    53    54    45    71    69    64    96    90    
     39    53    54    45    71    69    63    96    90    

B1   68    82    62    119   138   87    96    126   99    
     69    82    62    119   138   87    96    126   99    
     69    82    62    119   138   87    96    126   99    
     69    82    62    119   138   87    96    126   99    

bg   39    53    53    45    71    69    63    96    90    
     39    53    53    45    71    69    63    95    90    
     39    53    53    45    71    69    63    95    89    
     38    53    53    45    71    69    63    95    89    

B2   59    99    83    88    186   139   82    136   118   
     59    99    83    88    186   139   82    136   118   
     59    99    83    88    186   139   82    136   117   
     59    99    83    88    186   139   81    135   117   

bg   38    52    52    44    69    68    62    93    88    
     38    52    52    44    69    67    62    93    87    
     38    52    52    44    69    67    61    93    87    
     37    52    52    44    69    67    61    92    86    

B3   41    74    84    50    124   151   65    116   124   
     40    74    84    49    123   151   64    116   124   
     40    73    84    49    123   150   64    115   123   
     40    73    83    49    122   150   63    115   123   

bg   36    49    49    42    65    64    58    88    83    
     36    49    49    42    65    63    58    88    82    
     35    49    49    42    65    63    58    87    82    
     35    49    49    42    65    63    58    87    82    

C1   39    52    51    74    95    74    138   163   102   
     39    52    51    74    95    74    138   163   102   
     39    52    51    74    95    74    138   163   102   
     39    52    51    74    95    74    138   163   102   

bg   35    48    49    41    65    63    58    87    82    
     35    48    49    41    65    63    57    87    81    
     35    48    49    41    64    63    57    86    81    
     35    48    48    41    64    62    57    86    81    

C2   37    52    51    60    108   94    107   207   152   
     37    52    51    60    108   94    107   207   152   
     37    52    51    60    108   93    107   207   151   
     37    52    51    60    108   93    107   206   151   

bg   34    47    48    40    63    61    56    85    80    
     34    47    48    40    63    61    56    85    80    
     34    47    47    40    63    61    56    85    79    
     34    47    47    40    63    61    56    84    79    

C3   36    50    51    43    85    96    62    138   164   
     36    50    51    44    85    96    62    138   164   
     36    50    51    44    85    96    62    138   164   
     36    50    51    43    85    95    62    137   163   

bg   33    46    46    39    61    60    55    82    77    
     33    46    46    39    61    59    54    82    77    
     33    45    46    39    61    59    54    81    76    
     33    45    45    38    60    58    54    81    76    


Trial #4-------------------------

     A1    A2    A3    B1    B2    B3    C1    C2    C3    

A1   107   115   63    69    90    66    57    83    77    
     107   115   63    68    90    66    57    83    77    
     106   115   63    68    89    66    57    83    77    
     106   114   63    68    89    66    57    83    76    

bg   32    44    44    38    59    57    53    79    74    
     32    44    44    38    59    57    53    79    74    
     32    44    44    38    59    57    53    79    74    
     32    44    44    38    59    57    53    79    74    

A2   78    157   113   58    107   87    56    84    78    
     78    157   113   58    107   87    56    84    78    
     78    157   113   58    107   87    56    84    78    
     78    156   113   58    107   87    56    84    78    

bg   32    44    44    38    59    57    53    79    74    
     32    44    44    38    59    57    53    79    74    
     32    44    44    38    59    57    53    79    74    
     32    44    44    38    59    57    52    79    74    

A3   39    95    127   41    81    88    53    81    78    
     39    95    127   41    81    87    53    81    77    
     38    95    127   40    81    87    53    81    77    
     38    94    127   40    81    87    53    80    77    

bg   31    43    43    37    58    56    51    77    73    
     31    43    43    37    58    56    51    77    73    
     31    43    43    37    58    56    51    77    73    
     31    43    43    37    58    56    51    77    73    

B1   62    73    52    111   125   74    84    108   82    
     62    73    52    111   125   74    84    108   82    
     62    73    52    111   125   74    84    108   82    
     62    73    52    111   125   74    85    108   82    

bg   32    44    44    37    59    57    52    79    74    
     32    44    44    37    59    57    52    79    74    
     32    44    44    37    59    57    52    79    74    
     32    44    44    38    59    57    52    79    74    

B2   53    91    74    81    175   128   72    121   103   
     53    91    74    81    174   128   72    121   103   
     53    91    74    81    174   128   72    121   103   
     53    91    74    81    174   128   72    121   103   

bg   32    44    45    38    59    57    53    80    75    
     32    44    45    38    59    57    53    79    75    
     32    44    45    38    59    57    53    80    75    
     32    44    45    38    59    57    53    79    75    

B3   36    68    78    44    115   143   57    105   113   
     36    68    78    44    115   143   57    105   113   
     36    68    78    44    115   143   57    105   113   
     36    68    78    44    115   142   57    105   113   

bg   32    44    44    38    59    57    53    79    74    
     32    44    44    38    59    57    53    79    74    
     32    44    45    38    59    57    53    80    74    
     32    45    45    38    59    57    53    80    75    

C1   36    48    47    70    90    68    133   155   95    
     36    48    47    70    90    68    133   155   95    
     36    48    47    70    90    68    132   155   95    
     36    48    47    70    90    69    132   155   95    

bg   33    45    45    38    60    58    54    81    76    
     33    45    45    38    60    58    54    81    76    
     33    45    45    38    60    58    54    81    76    
     33    45    45    38    60    58    54    81    76    

C2   35    49    48    58    105   90    104   202   147   
     35    49    48    58    105   90    104   202   147   
     35    49    48    58    105   90    104   202   147   
     35    49    48    58    104   90    104   202   147   

bg   33    45    45    38    60    58    53    81    76    
     33    45    45    38    60    58    53    81    76    
     33    45    45    38    60    58    53    81    76    
     33    45    45    38    60    58    53    81    75    

C3   34    48    49    41    82    93    60    134   160   
     34    48    49    41    82    92    60    133   160   
     34    48    49    41    82    93    60    134   160   
     34    48    49    42    82    93    60    134   160   

bg   33    45    45    38    60    58    54    81    76    
     33    45    45    39    60    59    54    81    76    
     33    45    46    39    60    59    54    81    76    
     33    46    46    39    61    59    54    81    76    


