     A1    A2    A3    B1    B2    B3    C1    C2    C3    

A1   129   145   97    100   143   116   112   158   142   
     129   145   96    100   142   115   111   157   140   
     128   144   96    99    141   114   110   156   140   
     128   145   97    100   142   117   111   158   143   

bg   61    87    83    75    119   109   107   154   140   
     61    87    84    75    119   110   107   155   141   
     62    87    84    75    119   110   108   155   140   
     63    89    86    77    123   112   110   159   143   

A2   104   197   152   92    162   137   110   159   143   
     104   197   151   93    162   137   111   159   142   
     104   197   151   93    162   137   111   159   142   
     104   197   151   92    162   137   110   158   143   

bg   61    86    83    75    119   109   108   154   139   
     61    86    83    74    118   109   106   153   139   
     61    86    83    74    118   109   106   153   139   
     61    87    83    75    119   109   107   154   139   

A3   68    140   164   78    143   141   108   157   144   
     68    140   163   78    143   140   108   157   143   
     68    139   161   78    142   139   108   156   142   
     68    139   163   78    142   140   108   156   142   

bg   61    86    83    75    118   108   107   154   139   
     61    86    83    74    118   109   107   154   139   
     61    86    83    74    118   110   106   154   140   
     61    86    83    74    118   110   107   154   140   

B1   91    113   90    146   182   125   140   182   147   
     91    113   89    147   182   125   140   182   146   
     92    113   90    148   182   125   141   183   146   
     92    113   90    148   182   125   141   183   147   

bg   62    87    83    75    119   109   108   155   140   
     62    87    84    75    119   110   108   155   140   
     61    87    84    75    119   110   108   155   141   
     61    86    83    74    118   110   107   154   140   

B2   80    129   111   115   230   178   129   198   169   
     79    128   110   114   228   176   128   196   167   
     79    127   109   114   227   175   127   196   166   
     79    127   109   114   227   175   128   196   166   

bg   61    86    83    74    118   109   107   154   139   
     61    86    83    74    118   109   107   154   139   
     61    86    82    74    117   108   106   153   139   
     60    86    82    74    117   109   106   153   139   

B3   63    104   110   79    167   185   111   177   173   
     63    105   111   79    168   186   111   177   173   
     64    105   110   79    168   185   111   177   173   
     64    105   110   79    168   184   112   177   172   

bg   61    87    83    75    119   110   107   155   140   
     61    87    83    75    119   109   108   155   139   
     61    86    83    74    118   109   107   154   139   
     61    86    83    74    118   109   106   153   139   

C1   65    90    85    107   151   120   187   224   160   
     64    90    85    107   150   120   186   224   161   
     64    89    85    107   150   120   186   224   161   
     65    90    85    107   151   120   187   225   161   

bg   61    86    83    74    118   109   106   153   139   
     61    86    83    74    118   109   107   154   139   
     61    86    83    74    118   108   107   154   139   
     61    86    83    74    119   109   107   154   140   

C2   72    103   98    107   183   158   174   285   227   
     64    90    86    95    167   141   159   263   206   
     63    90    86    95    166   141   159   263   206   
     64    91    86    96    167   141   159   263   206   

bg   61    87    83    74    119   110   107   154   140   
     62    87    84    76    120   111   109   156   141   
     62    87    83    75    119   109   108   155   140   
     61    86    83    75    119   109   107   154   140   

C3   62    88    85    77    140   139   114   202   209   
     62    88    85    77    140   139   114   201   210   
     62    88    85    77    140   140   114   201   210   
     62    88    86    77    140   140   114   202   210   

bg   61    86    83    74    118   109   106   153   139   
     61    86    83    74    118   109   107   154   140   
     62    87    83    75    119   109   108   155   140   
     61    86    83    75    118   109   107   154   139   
