     A1    A2    A3    B1    B2    B3    C1    C2    C3    

A1   123   139   94    97    138   113   109   154   138   
     123   140   94    97    139   114   109   155   139   
     123   140   95    97    139   114   109   155   139   
     123   139   94    97    139   114   109   155   139   

bg   60    85    82    73    116   107   105   151   137   
     60    85    82    73    116   107   105   151   137   
     60    85    82    73    116   107   105   151   137   
     60    85    82    73    116   107   105   151   137   

A2   104   197   152   93    163   138   111   160   144   
     105   198   153   93    164   138   112   160   144   
     104   197   152   93    163   137   110   159   143   
     103   196   151   92    161   136   110   157   142   

bg   60    84    81    73    116   107   105   150   136   
     60    85    82    73    117   107   105   151   137   
     60    85    82    73    116   107   105   151   137   
     60    85    81    73    116   107   105   151   137   

A3   67    139   162   77    142   140   108   155   142   
     68    139   162   77    142   140   108   156   142   
     68    139   162   77    142   140   108   156   142   
     67    139   162   77    142   140   108   155   142   

bg   59    84    81    72    115   106   104   150   135   
     60    84    81    73    115   106   104   150   136   
     60    85    82    73    116   107   105   151   137   
     60    85    82    73    116   107   105   151   137   

B1   91    112   89    147   181   124   140   182   146   
     92    114   90    148   183   126   142   184   148   
     91    113   90    147   182   125   141   183   147   
     91    112   89    147   181   124   140   182   146   

bg   60    85    82    73    117   107   106   152   137   
     60    85    82    73    117   107   105   151   137   
     60    85    82    73    116   107   105   151   137   
     61    86    82    74    118   108   106   153   138   

B2   78    126   108   113   227   174   126   194   164   
     78    126   109   113   226   174   126   194   164   
     78    126   108   113   226   174   126   194   164   
     78    126   108   113   226   174   126   194   164   

bg   60    85    82    74    117   107   106   152   137   
     60    85    82    73    117   107   106   152   137   
     60    85    82    73    117   107   106   152   137   
     60    85    82    73    117   107   106   152   137   

B3   63    104   109   78    166   184   110   175   171   
     63    104   109   78    167   184   110   175   171   
     63    104   109   78    167   184   110   176   171   
     63    104   109   78    167   184   110   176   171   

bg   60    85    82    74    117   108   106   152   138   
     60    85    82    73    117   108   106   152   137   
     60    85    82    73    117   108   106   152   137   
     60    85    82    73    117   108   106   152   137   

C1   64    89    84    107   150   119   186   224   160   
     64    89    84    107   150   119   186   223   159   
     65    90    85    107   151   120   187   225   161   
     64    89    84    107   150   119   186   224   160   

bg   60    85    82    74    117   108   106   152   137   
     60    85    82    73    117   107   106   152   137   
     60    85    82    73    117   107   106   152   137   
     61    86    82    74    117   108   106   153   138   

C2   63    89    85    95    165   140   158   262   204   
     63    89    85    95    166   140   158   262   204   
     63    90    85    95    166   140   158   262   205   
     64    92    87    97    168   143   161   265   208   

bg   60    85    81    73    116   107   105   151   137   
     60    85    82    73    117   107   105   152   137   
     60    85    82    73    117   107   105   152   137   
     61    86    83    74    118   109   107   153   138   

C3   61    87    85    77    139   138   113   200   208   
     62    88    85    77    139   138   113   200   209   
     61    88    85    77    139   139   113   200   209   
     61    87    85    77    139   138   113   200   208   

bg   60    85    82    74    117   108   106   152   138   
     60    85    82    73    117   107   106   152   137   
     60    85    81    73    116   107   105   151   136   
     60    85    81    73    116   107   105   151   137   
