     A1    A2    A3    B1    B2    B3    C1    C2    C3    

A1   128   144   96    99    141   115   110   156   140   
     128   144   95    99    140   114   109   155   139   
     128   143   95    98    140   114   109   155   139   
     127   143   95    98    140   114   109   155   139   

bg   61    86    83    74    118   109   107   154   140   
     60    85    82    74    117   108   106   153   138   
     60    85    82    73    117   107   105   152   137   
     61    85    82    74    117   108   106   153   138   

A2   103   195   150   91    161   136   109   156   141   
     103   196   151   92    161   136   109   157   141   
     103   196   150   92    161   136   109   157   141   
     103   195   150   91    161   136   109   157   141   

bg   61    86    82    74    118   109   107   153   139   
     60    85    81    73    116   107   105   151   136   
     59    84    80    72    114   106   104   149   135   
     60    85    81    73    116   107   105   151   137   

A3   67    139   162   77    142   140   107   155   142   
     67    139   162   77    142   140   107   155   142   
     67    139   162   77    142   140   108   155   142   
     67    139   162   77    142   140   107   155   142   

bg   61    86    82    74    117   108   106   153   138   
     60    85    82    73    117   108   106   152   138   
     60    85    82    73    117   108   106   152   138   
     60    85    82    73    117   108   106   152   138   

B1   92    114   91    148   184   126   142   185   149   
     92    114   90    148   183   126   142   184   148   
     91    113   89    147   182   125   141   183   146   
     91    112   89    147   181   124   140   182   146   

bg   60    85    82    74    117   108   106   152   138   
     60    85    82    74    117   108   106   152   138   
     60    85    82    73    117   107   105   152   137   
     60    85    82    73    117   108   106   152   138   

B2   80    129   110   115   229   177   130   198   169   
     90    144   125   129   254   200   152   227   200   
     78    127   109   113   227   175   127   195   166   
     78    126   109   113   226   174   126   194   165   

bg   61    86    82    74    118   108   106   153   138   
     61    86    83    74    118   109   107   154   139   
     61    86    83    74    118   109   107   153   139   
     61    86    83    74    118   109   107   153   139   

B3   63    104   110   79    167   184   111   176   172   
     64    105   110   79    168   185   111   177   172   
     63    105   110   79    167   185   111   177   172   
     63    104   109   78    167   184   110   176   171   

bg   60    85    82    74    117   108   106   152   138   
     60    85    82    73    117   108   106   152   137   
     60    85    82    73    117   108   106   152   137   
     60    85    82    74    117   108   106   152   138   

C1   64    89    84    106   149   119   185   222   159   
     64    89    84    106   149   119   185   223   159   
     64    89    84    106   149   119   185   222   159   
     64    89    84    106   150   119   185   223   160   

bg   60    86    82    74    117   108   106   152   138   
     60    85    82    74    117   108   106   152   138   
     60    85    82    74    117   108   106   152   138   
     61    85    82    74    117   108   106   152   138   

C2   64    91    86    96    167   142   160   264   207   
     64    91    86    96    167   141   160   264   206   
     65    92    87    97    168   143   161   265   208   
     64    92    88    98    169   145   162   266   209   

bg   60    85    82    74    117   108   106   152   138   
     60    85    82    73    116   107   105   151   137   
     60    85    82    73    117   107   105   152   137   
     60    85    82    73    117   108   106   152   138   

C3   61    87    85    76    139   138   113   200   208   
     62    88    85    77    139   138   113   200   209   
     61    87    85    77    139   138   113   200   208   
     61    87    85    77    139   138   113   200   208   

bg   61    85    82    74    117   108   106   152   138   
     61    86    82    74    117   108   106   152   138   
     60    85    82    74    117   108   106   152   138   
     61    86    82    74    117   108   106   153   138   
