     A1    A2    A3    B1    B2    B3    C1    C2    C3    

A1   124   141   95    97    139   114   109   155   140   
     124   141   95    97    140   115   110   156   140   
     124   141   96    98    140   115   110   156   140   
     124   141   95    98    140   114   110   156   140   

bg   61    86    82    74    118   108   106   153   138   
     61    86    82    74    118   108   106   153   138   
     61    86    82    74    118   108   106   153   138   
     60    86    82    74    117   108   106   153   138   

A2   104   197   151   92    162   137   110   158   143   
     104   197   152   92    162   137   110   159   143   
     104   197   152   92    163   137   111   159   143   
     104   197   151   92    162   137   111   159   142   

bg   61    86    82    74    118   108   106   153   138   
     61    85    82    74    117   108   106   152   138   
     61    86    83    74    118   109   107   153   139   
     61    86    82    74    117   108   106   153   138   

A3   71    144   167   82    149   146   114   164   150   
     72    145   169   83    150   148   115   167   152   
     69    142   165   79    146   144   111   161   146   
     68    140   163   78    143   141   109   157   144   

bg   61    86    82    74    117   108   106   153   138   
     61    86    82    74    118   109   106   153   139   
     61    86    82    74    118   108   106   153   139   
     61    86    82    74    118   108   107   153   138   

B1   91    112   89    147   181   124   140   182   146   
     91    112   89    147   181   123   140   181   145   
     91    112   89    147   181   124   140   182   145   
     91    113   89    147   182   124   140   182   146   

bg   60    85    82    73    117   108   106   152   137   
     61    85    82    74    117   108   106   153   138   
     60    85    82    74    117   108   106   152   138   
     60    85    82    73    117   108   106   152   138   

B2   78    127   109   114   228   175   127   196   166   
     79    127   109   114   228   176   127   196   166   
     78    127   109   113   227   175   127   195   166   
     79    128   110   114   228   176   128   197   167   

bg   61    86    82    74    117   108   106   153   138   
     61    86    82    74    118   108   107   153   138   
     61    86    83    74    118   109   107   153   139   
     61    86    83    74    118   109   107   154   139   

B3   63    103   109   78    166   183   110   175   170   
     63    104   109   78    167   184   110   176   171   
     63    104   110   79    167   184   111   176   172   
     64    105   110   79    168   185   111   177   172   

bg   61    86    82    74    118   108   106   153   139   
     61    86    83    74    118   109   107   153   139   
     61    86    83    74    118   109   107   154   139   
     61    86    83    74    118   109   107   154   139   

C1   64    89    84    106   150   119   186   223   160   
     64    89    84    107   150   119   186   223   160   
     64    89    84    107   150   119   186   223   160   
     64    89    84    107   150   120   185   223   160   

bg   61    86    82    74    117   108   106   153   138   
     61    86    82    74    118   108   106   153   139   
     61    86    82    74    117   108   106   153   138   
     61    86    82    74    118   108   106   153   138   

C2   63    90    85    95    166   140   158   263   205   
     63    90    85    95    166   140   158   262   205   
     63    90    85    95    166   140   159   262   205   
     63    90    85    95    166   141   159   262   205   

bg   61    86    82    74    118   108   106   153   138   
     61    86    82    74    117   108   106   153   138   
     61    86    82    74    117   108   106   153   138   
     61    86    82    74    117   108   106   153   138   

C3   62    88    85    77    139   139   113   201   209   
     62    88    85    77    140   139   114   201   210   
     62    88    85    77    140   139   114   201   209   
     62    88    85    77    140   139   114   201   210   

bg   61    86    82    74    118   108   107   153   138   
     61    86    82    74    117   108   106   153   138   
     61    86    82    74    118   108   106   153   139   
     60    85    82    73    117   107   106   152   137   
