Trial #1-------------------------

     A1    A2    A3    B1    B2    B3    C1    C2    C3    

A1   116   127   70    71    95    70    61    86    78    
     116   126   71    70    96    70    61    86    78    
     115   126   70    70    96    70    60    86    78    
     115   126   70    70    96    70    61    86    78    

bg   42    55    52    41    67    61    57    83    76    
     42    57    52    41    65    61    57    83    76    
     42    57    52    41    67    61    57    83    76    
     42    57    52    39    67    61    57    83    75    

A2   88    168   120   58    111   90    61    87    80    
     87    168   119   59    112   90    60    87    80    
     87    167   120   59    112   90    59    87    80    
     88    167   119   59    112   90    60    87    80    

bg   41    57    52    40    66    62    56    83    76    
     42    56    52    40    66    61    57    83    75    
     42    57    52    40    66    61    57    83    76    
     42    57    53    41    66    61    57    82    76    

A3   49    107   133   44    88    91    59    85    78    
     48    107   133   44    89    91    58    85    80    
     49    107   133   44    89    91    59    85    80    
     48    107   134   44    89    91    58    85    80    

bg   42    57    52    40    66    61    56    82    76    
     41    57    52    40    66    61    56    83    76    
     41    56    52    40    66    61    56    82    76    
     41    57    52    40    66    61    56    81    76    

B1   71    85    60    114   131   78    89    112   84    
     71    85    59    113   132   78    89    112   83    
     72    85    59    114   132   78    90    112   84    
     71    85    59    114   132   78    89    112   82    

bg   42    57    51    39    66    61    57    82    76    
     41    56    51    40    66    61    57    82    76    
     41    57    53    40    66    61    56    82    76    
     41    54    51    39    66    61    56    82    76    

B2   61    101   81    81    181   131   75    123   104   
     61    102   81    83    181   131   75    123   104   
     61    102   80    82    181   131   75    123   104   
     61    102   80    82    181   130   75    123   104   

bg   42    56    51    40    66    60    57    82    75    
     42    56    51    40    66    60    57    82    75    
     42    56    50    40    66    60    56    82    75    
     43    56    50    40    66    60    56    82    74    

B3   45    79    83    46    121   145   60    107   113   
     45    78    83    46    121   145   60    107   113   
     45    79    83    46    121   145   60    107   113   
     45    79    83    46    121   144   60    107   113   

bg   42    56    50    40    66    59    56    82    74    
     41    57    50    39    66    59    57    83    74    
     42    57    50    41    66    60    57    83    74    
     42    54    51    41    67    60    58    82    74    

C1   45    60    54    72    96    70    136   157   93    
     45    60    52    72    96    70    135   157   93    
     45    57    52    72    95    70    135   156   93    
     45    60    52    71    94    70    135   156   93    

bg   41    56    50    39    66    59    57    82    73    
     41    56    50    40    66    59    56    82    73    
     41    56    50    40    66    59    56    82    71    
     41    56    50    39    66    59    56    80    73    

C2   44    60    54    58    110   90    106   203   144   
     45    60    53    59    110   90    106   203   144   
     44    60    53    59    110   90    106   203   144   
     44    60    53    59    110   90    106   203   144   

bg   41    55    50    40    66    59    56    82    73    
     41    56    50    40    66    59    56    82    74    
     41    56    51    40    65    59    57    82    73    
     41    56    50    40    66    59    56    82    73    

C3   44    59    53    43    87    93    62    134   157   
     43    59    53    43    86    93    62    134   156   
     43    59    53    43    87    93    62    134   156   
     44    59    53    43    86    93    62    134   156   

bg   41    56    50    40    66    59    56    82    73    
     41    53    50    39    66    59    56    82    71    
     41    56    50    40    64    59    57    82    73    
     41    56    50    40    66    59    56    82    73    


Trial #2-------------------------

     A1    A2    A3    B1    B2    B3    C1    C2    C3    

A1   116   126   68    70    95    67    60    85    74    
     116   126   68    70    95    67    60    85    75    
     116   126   68    70    95    67    60    85    75    
     116   125   68    70    95    67    60    85    75    

bg   41    56    50    39    66    59    56    82    73    
     41    56    51    40    66    59    56    82    73    
     41    54    50    40    65    59    56    82    73    
     41    56    50    40    66    59    56    81    73    

A2   86    167   119   59    112   88    59    86    77    
     86    167   118   59    110   88    59    86    77    
     86    167   117   59    112   87    59    86    77    
     86    167   117   59    111   87    59    86    75    

bg   41    56    50    40    64    59    56    82    73    
     43    56    50    40    66    59    56    82    73    
     41    56    51    40    64    59    56    82    73    
     41    56    50    40    66    59    56    80    73    

A3   48    104   132   43    88    89    58    84    77    
     48    106   132   43    88    89    57    84    77    
     48    106   133   43    88    90    57    84    78    
     48    106   134   43    88    90    57    84    78    

bg   42    56    50    40    65    59    56    82    73    
     41    56    50    39    65    59    56    82    73    
     41    55    51    40    65    59    56    82    73    
     43    56    50    40    66    59    56    82    73    

B1   71    84    57    114   132   76    90    111   82    
     71    83    57    114   130   76    89    111   82    
     71    84    57    114   131   76    88    111   80    
     71    84    57    113   131   76    88    111   82    

bg   41    56    50    39    63    59    56    81    73    
     41    56    50    40    65    59    56    81    72    
     41    56    50    40    65    59    56    81    73    
     41    56    50    40    65    59    56    81    73    

B2   61    101   79    82    180   129   75    122   101   
     61    101   79    82    180   128   75    122   101   
     61    101   79    82    180   128   76    122   101   
     61    101   79    82    180   128   75    122   101   

bg   41    56    50    40    65    59    56    81    73    
     41    56    51    40    65    59    56    81    73    
     41    56    50    40    65    59    56    81    73    
     41    56    50    40    65    59    56    80    73    

B3   45    79    84    46    121   144   60    106   112   
     46    78    82    46    121   144   60    106   112   
     45    79    82    46    121   143   62    106   111   
     45    76    83    46    121   143   60    106   111   

bg   41    55    49    40    64    59    56    82    71    
     41    56    49    39    65    59    56    81    73    
     41    56    51    40    65    59    56    81    73    
     41    56    50    40    65    59    56    81    73    

C1   44    59    51    71    95    69    134   156   93    
     44    59    51    71    95    69    134   155   93    
     44    59    51    71    94    69    134   155   93    
     46    59    52    71    94    69    134   155   93    

bg   41    56    49    39    65    59    56    81    73    
     41    56    49    40    65    59    56    81    73    
     41    56    49    40    65    59    56    81    73    
     41    56    49    40    64    59    56    81    71    

C2   44    60    52    59    109   90    106   203   144   
     43    60    52    59    109   90    105   202   144   
     43    60    52    59    109   90    105   202   144   
     43    57    53    59    109   90    105   202   144   

bg   41    56    50    40    65    59    56    81    73    
     41    56    50    40    65    59    56    81    73    
     41    53    50    40    65    59    56    81    73    
     41    56    50    40    65    59    56    81    73    

C3   42    58    54    43    87    92    62    133   156   
     42    58    53    41    87    93    62    133   156   
     42    58    53    43    87    93    62    133   156   
     42    58    53    43    87    93    61    133   156   

bg   41    56    50    40    65    59    57    81    73    
     42    56    51    39    65    59    56    81    73    
     41    56    50    40    65    59    56    81    73    
     41    54    49    40    64    59    56    80    73    


Trial #3-------------------------

     A1    A2    A3    B1    B2    B3    C1    C2    C3    

A1   116   125   69    70    95    67    60    85    75    
     116   125   67    70    95    67    60    85    72    
     115   125   67    70    93    67    60    85    74    
     115   125   68    69    95    67    60    84    74    

bg   41    56    49    40    65    58    56    81    73    
     41    56    49    40    65    58    55    81    73    
     41    56    50    40    65    58    56    81    73    
     42    56    49    40    64    58    55    81    73    

A2   85    166   117   58    111   86    58    85    76    
     86    164   117   59    111   86    58    85    76    
     86    166   117   58    111   86    59    85    74    
     85    165   116   58    111   86    59    85    76    

bg   41    54    49    40    65    58    56    81    72    
     41    56    49    40    65    58    56    81    71    
     41    56    49    40    65    58    56    81    72    
     41    54    49    40    65    58    56    81    72    

A3   47    106   132   43    87    89    57    84    76    
     47    106   132   41    87    89    57    84    76    
     47    104   132   43    86    88    57    84    76    
     47    106   132   43    87    88    57    84    76    

bg   41    56    49    40    65    58    56    81    72    
     41    56    51    40    63    58    56    81    72    
     41    56    49    40    65    58    56    81    72    
     41    56    49    40    64    58    56    81    72    

B1   70    84    57    112   130   75    87    110   81    
     71    84    57    112   130   75    87    110   81    
     70    84    57    112   130   75    87    110   81    
     70    84    57    111   130   75    87    110   81    

bg   41    53    49    40    65    58    55    81    71    
     41    56    51    40    65    58    57    81    72    
     41    56    49    40    65    58    56    81    71    
     41    56    49    40    65    58    56    80    72    

B2   61    101   78    82    178   128   75    122   101   
     61    101   78    82    179   128   74    122   101   
     61    100   78    81    179   128   74    121   101   
     62    101   80    82    179   128   74    121   101   

bg   41    56    49    40    65    59    55    81    73    
     41    54    49    40    63    58    55    81    73    
     42    56    50    40    65    58    55    81    73    
     41    56    49    40    65    58    55    81    70    

B3   44    78    82    46    120   142   61    106   110   
     45    78    82    44    120   142   60    106   110   
     45    78    82    46    120   142   60    106   108   
     44    78    82    46    120   142   60    106   110   

bg   41    56    50    40    65    59    55    81    72    
     41    55    50    40    65    59    55    81    72    
     41    55    50    40    65    59    55    81    72    
     41    55    50    40    65    59    56    81    72    

C1   44    59    51    71    93    69    134   155   91    
     44    59    51    71    95    69    135   155   92    
     44    59    52    71    95    69    136   155   92    
     44    59    51    72    95    69    135   155   91    

bg   41    56    49    40    65    58    56    81    72    
     42    55    51    40    65    58    55    81    72    
     41    55    49    40    65    58    55    81    73    
     41    53    49    40    65    59    55    81    73    

C2   43    58    53    58    109   90    105   201   144   
     43    60    53    58    109   90    105   201   142   
     43    60    53    58    109   90    105   201   144   
     43    60    55    59    109   90    105   201   144   

bg   41    56    50    40    65    59    56    81    72    
     41    56    50    40    65    60    56    81    74    
     41    56    50    40    65    60    56    81    74    
     42    56    50    40    65    60    56    80    74    

C3   42    58    54    43    87    94    61    133   159   
     42    58    54    41    87    95    62    133   159   
     43    58    54    43    87    95    61    133   159   
     42    58    56    43    87    95    61    133   159   

bg   41    56    51    40    65    60    56    81    75    
     41    56    51    40    65    60    56    81    74    
     41    56    50    40    65    60    56    81    74    
     41    56    50    40    65    60    56    81    74    


Trial #4-------------------------

     A1    A2    A3    B1    B2    B3    C1    C2    C3    

A1   116   126   68    69    95    68    60    84    76    
     116   125   68    70    95    68    61    84    76    
     114   123   68    70    94    68    60    84    76    
     114   125   68    69    94    68    60    84    77    

bg   41    56    51    40    65    60    56    81    75    
     41    54    51    40    65    60    55    81    75    
     41    56    51    40    64    60    55    81    74    
     41    56    51    40    65    60    55    81    74    

A2   86    167   118   59    111   88    59    85    78    
     87    167   118   59    111   88    59    85    78    
     86    167   119   59    111   88    59    85    78    
     86    164   118   59    109   88    60    85    78    

bg   42    56    51    40    65    60    56    81    75    
     41    56    53    39    65    60    55    81    75    
     41    56    51    40    65    60    56    81    74    
     41    56    51    40    65    60    56    81    75    

A3   48    106   133   43    88    91    57    84    79    
     48    106   133   42    88    91    57    84    79    
     48    106   133   43    88    90    57    84    79    
     48    106   134   43    88    90    58    84    79    

bg   41    56    51    40    65    60    56    81    74    
     41    53    51    40    65    60    56    81    75    
     42    56    51    40    64    60    57    81    75    
     41    56    51    40    65    60    56    80    73    

B1   70    82    59    112   131   77    87    110   83    
     70    84    59    112   129   77    88    110   83    
     71    84    59    112   130   77    88    110   82    
     71    82    59    113   129   77    88    110   83    

bg   41    56    51    40    65    60    56    81    74    
     42    56    51    40    65    60    56    81    74    
     41    54    51    39    64    60    56    81    75    
     41    56    51    40    65    60    56    81    75    

B2   61    102   80    82    180   130   74    122   102   
     61    102   80    82    180   130   74    122   103   
     61    102   80    82    180   130   74    122   103   
     61    102   80    82    179   130   74    122   102   

bg   41    56    51    40    65    60    56    81    74    
     41    56    51    39    65    60    56    81    74    
     41    56    51    40    64    60    56    81    74    
     41    56    51    40    65    60    56    81    74    

B3   46    76    83    46    120   144   60    106   113   
     45    78    83    45    118   144   60    106   111   
     45    78    84    46    120   144   60    106   113   
     45    78    83    46    120   144   60    106   113   

bg   41    56    51    40    63    60    55    81    73    
     41    56    53    40    65    60    57    81    75    
     41    56    51    40    65    60    56    81    75    
     41    56    51    40    65    60    56    81    75    

C1   45    60    53    72    95    70    136   156   94    
     45    58    53    72    95    70    135   156   94    
     46    59    53    72    95    70    135   156   94    
     44    59    54    72    95    70    135   156   94    

bg   41    56    51    40    64    60    55    81    75    
     41    56    51    40    65    60    56    81    74    
     41    56    51    39    65    60    55    81    75    
     41    56    51    40    65    60    56    81    73    

C2   43    60    54    59    109   91    105   202   145   
     44    60    54    59    107   91    105   202   145   
     44    60    54    59    109   91    105   202   145   
     44    60    54    59    109   91    106   202   145   

bg   41    56    52    40    65    61    56    82    75    
     41    56    51    38    66    61    56    82    75    
     41    56    51    40    65    60    56    81    75    
     41    56    51    40    65    60    57    81    75    

C3   42    58    54    43    87    95    61    134   159   
     42    58    54    43    87    94    61    133   159   
     42    58    54    43    87    94    61    133   159   
     42    56    54    43    87    94    61    133   158   

bg   42    55    51    40    65    60    56    81    74    
     41    56    52    40    65    60    56    81    74    
     41    54    51    40    65    60    56    81    74    
     41    56    51    40    65    60    56    81    74    

