Trial #1-------------------------

     A1    A2    A3    B1    B2    B3    C1    C2    C3    

A1   112   120   64    66    88    62    54    76    68    
     112   120   63    66    88    62    54    76    68    
     112   120   63    66    88    62    55    76    68    
     111   119   63    66    88    62    54    72    68    

bg   37    49    45    36    58    54    50    71    66    
     37    51    45    35    58    54    49    72    66    
     38    51    45    35    58    54    49    72    66    
     37    50    45    35    58    54    49    74    66    

A2   82    162   115   54    104   82    52    76    69    
     82    162   113   54    104   82    52    76    69    
     82    161   113   54    103   82    52    76    69    
     82    162   113   54    104   82    52    72    69    

bg   37    51    45    35    58    53    50    70    66    
     37    49    45    35    56    53    50    72    66    
     37    51    45    35    58    53    50    72    66    
     37    51    45    34    57    53    49    73    66    

A3   44    101   130   37    80    84    51    74    70    
     44    101   129   38    81    84    52    73    70    
     44    101   128   38    81    84    51    74    70    
     44    101   128   38    81    84    51    72    70    

bg   37    51    45    35    58    53    50    72    66    
     37    51    45    35    57    53    50    72    66    
     37    51    47    36    58    53    50    72    66    
     37    51    45    35    58    53    50    101   66    

B1   67    79    53    109   122   70    82    101   74    
     67    79    53    108   124   70    81    101   74    
     68    79    53    108   124   70    81    101   73    
     66    79    53    108   123   70    82    72    75    

bg   37    51    46    35    58    54    50    72    66    
     38    48    46    34    58    54    50    72    66    
     37    51    45    36    58    54    50    72    66    
     37    51    45    36    58    54    50    102   66    

B2   57    94    75    78    173   124   69    114   95    
     58    97    75    77    174   124   69    114   95    
     58    97    75    78    174   124   69    114   95    
     58    97    76    78    174   124   69    74    96    

bg   38    51    46    36    59    55    50    71    67    
     37    51    47    36    59    54    50    72    67    
     37    49    46    36    59    54    51    72    66    
     38    51    46    36    58    54    50    86    66    

B3   41    73    79    41    113   138   54    97    104   
     41    71    78    42    113   138   54    97    104   
     41    73    78    42    113   138   54    97    104   
     41    73    78    42    113   138   54    72    104   

bg   37    51    45    35    58    53    49    70    64    
     37    51    47    35    58    53    50    72    66    
     37    51    45    34    58    53    49    72    66    
     37    49    45    35    58    54    49    146   66    

C1   40    54    47    67    87    64    128   146   85    
     41    54    47    67    87    64    128   146   85    
     40    54    47    65    88    64    128   146   85    
     40    54    49    67    86    64    128   102   85    

bg   37    51    45    35    58    53    50    72    66    
     37    51    45    35    58    53    50    72    64    
     37    51    45    35    58    53    49    72    66    
     37    51    45    35    58    53    50    72    65    

C2   39    54    48    54    102   85    99    193   136   
     39    53    48    54    100   85    99    193   137   
     39    54    48    54    102   85    99    192   137   
     40    54    48    54    100   85    99    193   137   

bg   37    50    46    35    58    53    49    72    66    
     37    51    45    35    58    53    50    72    66    
     37    51    45    35    57    53    50    72    66    
     37    48    45    34    58    54    51    113   66    

C3   39    53    49    37    80    88    55    124   151   
     39    53    49    38    80    88    55    124   151   
     39    51    51    38    80    88    56    124   151   
     38    53    49    37    80    88    55    72    149   

bg   37    51    45    34    57    54    49    70    66    
     37    51    45    35    58    53    49    72    66    
     37    51    45    35    58    53    49    72    66    
     37    51    45    35    58    53    49    73    66    


Trial #2-------------------------

     A1    A2    A3    B1    B2    B3    C1    C2    C3    

A1   112   120   63    66    88    62    53    75    68    
     112   120   63    66    86    62    54    74    67    
     111   120   63    65    88    62    53    75    68    
     111   120   63    65    88    62    53    72    68    

bg   37    51    45    35    58    54    49    72    66    
     37    51    45    35    58    54    49    72    66    
     37    51    45    35    58    54    49    72    66    
     38    51    45    35    58    54    49    76    66    

A2   83    162   113   54    105   82    53    76    69    
     82    162   113   53    105   82    54    76    69    
     83    160   113   54    105   82    53    76    68    
     82    162   113   54    105   82    53    74    69    

bg   37    51    45    35    56    53    50    72    66    
     37    50    45    34    58    54    49    72    64    
     37    51    45    35    58    54    49    72    66    
     37    50    45    35    58    53    49    74    66    

A3   44    101   128   38    80    84    51    74    70    
     44    101   129   38    80    84    51    74    70    
     44    101   128   39    81    84    51    74    70    
     44    98    127   38    81    84    52    74    70    

bg   37    50    46    36    58    54    50    72    66    
     37    51    46    36    58    54    50    72    66    
     37    49    46    36    59    54    51    72    65    
     37    51    47    36    57    54    50    101   66    

B1   66    79    53    108   124   70    81    101   75    
     68    79    53    108   124   70    81    101   75    
     67    79    53    107   124   70    81    101   75    
     67    79    53    108   124   70    82    72    75    

bg   38    51    45    35    58    53    50    70    65    
     37    50    45    35    58    53    50    72    66    
     37    51    45    35    58    53    50    72    66    
     37    51    45    35    58    53    50    86    66    

B2   57    96    74    77    173   123   68    112   94    
     57    96    75    77    173   123   68    113   94    
     57    96    75    77    171   124   68    113   94    
     57    96    75    77    173   123   68    82    94    

bg   37    51    45    35    58    53    49    72    66    
     37    51    45    35    58    53    50    72    66    
     38    51    45    35    58    53    49    72    66    
     37    51    45    35    58    53    49    96    66    

B3   41    73    79    41    113   138   54    96    102   
     41    73    78    41    113   137   53    96    104   
     41    73    78    41    113   138   53    96    103   
     41    73    79    40    113   138   53    81    104   

bg   37    50    45    35    58    53    49    72    66    
     38    49    45    35    57    53    49    72    66    
     37    51    47    35    58    53    49    72    66    
     37    49    45    35    58    53    49    137   66    

C1   41    52    47    67    86    64    129   147   85    
     40    54    47    67    88    64    129   146   85    
     41    54    47    66    87    64    129   146   85    
     40    54    47    67    88    64    129   72    83    

bg   37    51    45    35    58    54    50    70    66    
     37    51    45    35    58    54    49    72    66    
     37    50    45    35    58    54    49    72    66    
     37    51    45    35    58    54    50    72    66    

C2   40    55    48    54    100   85    99    193   137   
     40    55    48    54    102   85    99    193   137   
     41    55    48    54    102   85    101   193   137   
     40    55    48    55    102   85    99    193   137   

bg   37    51    45    36    58    54    50    70    66    
     37    51    45    35    58    54    50    72    66    
     37    51    45    35    58    54    50    72    66    
     37    51    45    35    58    54    49    93    65    

C3   38    53    49    38    79    88    55    124   150   
     39    53    49    38    80    88    56    124   150   
     39    53    50    38    80    88    55    124   150   
     39    53    49    37    79    87    55    82    150   

bg   38    51    45    34    58    53    50    72    66    
     37    51    47    36    58    54    50    72    64    
     37    51    45    36    58    53    50    72    66    
     37    51    45    36    58    53    50    75    66    


Trial #3-------------------------

     A1    A2    A3    B1    B2    B3    C1    C2    C3    

A1   112   121   63    66    88    62    53    75    68    
     111   118   63    65    88    62    55    75    68    
     111   120   63    65    88    62    53    75    68    
     111   120   64    65    88    62    53    73    68    

bg   37    48    46    36    58    54    51    72    66    
     37    51    46    36    58    54    50    72    66    
     38    51    45    36    58    54    50    72    64    
     37    50    45    36    58    54    50    75    66    

A2   82    161   113   54    104   82    52    76    69    
     82    161   113   54    104   82    52    76    68    
     82    159   113   54    104   82    52    76    69    
     82    160   112   54    102   82    52    72    69    

bg   37    51    47    35    58    54    49    70    66    
     37    50    45    34    58    53    49    72    66    
     37    50    45    35    57    53    50    72    66    
     37    50    45    35    58    53    49    73    66    

A3   44    101   128   38    80    84    51    74    70    
     44    101   128   39    80    84    51    74    70    
     44    100   127   39    80    84    51    74    69    
     45    100   127   38    80    84    51    72    70    

bg   37    48    45    34    57    53    49    70    66    
     37    50    45    35    58    53    49    72    66    
     37    50    45    35    57    53    49    72    66    
     37    50    47    35    58    54    49    101   66    

B1   67    79    53    108   123   70    81    101   72    
     66    79    53    108   122   70    82    101   75    
     67    77    54    108   124   70    82    102   75    
     67    79    53    108   123   70    82    73    75    

bg   37    51    46    36    59    54    50    72    67    
     38    49    46    36    59    54    51    72    66    
     37    51    45    35    59    54    50    72    66    
     37    51    45    36    58    54    50    113   66    

B2   57    96    74    77    173   123   69    112   94    
     57    96    74    77    173   123   68    112   93    
     57    96    74    77    173   122   68    112   93    
     57    95    74    77    172   122   68    96    92    

bg   37    50    44    35    56    52    49    72    63    
     37    50    44    34    58    52    49    72    64    
     37    50    45    35    58    52    49    72    62    
     38    50    44    35    58    52    49    93    64    

B3   40    73    77    41    113   136   54    96    102   
     40    73    78    41    113   136   53    96    102   
     40    73    77    41    113   136   54    96    102   
     40    73    77    41    113   136   53    71    102   

bg   38    50    44    35    58    52    49    70    64    
     37    50    44    35    58    52    49    72    64    
     37    50    45    35    58    52    49    71    64    
     37    50    44    35    58    52    49    108   62    

C1   40    52    46    67    87    62    129   146   83    
     40    54    46    67    87    62    128   146   84    
     40    54    46    67    87    62    129   146   83    
     40    54    46    67    87    62    128   79    84    

bg   37    50    44    35    58    52    49    70    64    
     37    50    44    35    58    52    49    71    64    
     37    48    44    34    58    52    49    71    64    
     37    50    45    35    58    52    49    71    64    

C2   39    54    47    54    101   83    99    192   132   
     40    52    47    54    101   83    99    192   135   
     39    54    47    54    100   83    99    192   135   
     40    54    47    54    101   83    99    192   135   

bg   37    50    45    35    58    53    50    72    65    
     37    50    45    35    58    53    49    72    66    
     37    50    45    35    58    53    49    72    66    
     37    49    45    35    58    53    49    124   66    

C3   39    53    50    38    80    87    55    124   150   
     39    53    49    38    80    87    55    124   148   
     39    53    49    38    79    87    55    124   149   
     39    53    50    38    80    87    55    100   149   

bg   37    50    45    34    58    53    51    72    65    
     37    50    45    35    57    53    49    72    66    
     37    51    47    35    58    53    49    72    66    
     37    50    45    34    56    54    49    75    66    


Trial #4-------------------------

     A1    A2    A3    B1    B2    B3    C1    C2    C3    

A1   112   121   63    65    88    62    53    75    68    
     111   119   63    65    88    62    53    75    68    
     111   120   63    65    87    62    53    75    68    
     111   120   64    65    88    62    54    72    68    

bg   37    50    45    36    58    54    50    70    66    
     38    51    45    36    58    54    50    72    66    
     37    51    45    35    58    54    51    72    66    
     37    48    45    35    58    54    50    74    64    

A2   82    161   113   54    103   82    52    76    70    
     82    161   113   54    104   82    52    74    70    
     82    158   113   54    104   82    52    76    70    
     82    161   113   54    104   82    52    72    70    

bg   37    51    45    35    58    53    49    71    66    
     37    51    45    34    58    53    50    72    66    
     37    51    45    36    58    54    50    72    66    
     38    51    45    36    58    54    50    74    66    

A3   44    101   128   39    81    84    51    74    70    
     44    101   128   38    80    84    51    74    70    
     45    101   129   39    81    84    51    74    70    
     44    101   128   38    81    84    51    73    70    

bg   37    51    46    35    58    54    50    72    66    
     37    51    47    36    58    54    50    72    66    
     37    51    45    36    58    54    50    72    65    
     37    51    45    34    58    54    50    101   66    

B1   67    79    53    107   124   70    83    101   75    
     67    79    53    108   124   70    82    101   75    
     67    79    53    108   124   70    82    101   75    
     66    79    55    108   123   70    81    72    75    

bg   38    51    46    35    58    54    50    72    66    
     37    50    46    35    58    54    50    72    66    
     37    51    46    35    58    54    50    72    66    
     37    51    46    35    58    54    50    98    64    

B2   57    96    75    78    173   123   68    113   94    
     57    96    75    78    173   123   68    113   94    
     57    96    75    78    173   123   69    113   93    
     57    94    75    78    171   123   68    72    94    

bg   37    49    47    36    58    54    50    70    66    
     37    51    45    34    58    54    50    72    66    
     38    49    45    35    58    54    50    72    66    
     37    51    45    35    58    54    50    84    66    

B3   41    73    78    42    113   138   54    97    104   
     41    73    78    40    113   138   54    95    104   
     41    73    78    42    113   138   54    97    104   
     41    73    78    42    112   137   54    75    103   

bg   37    51    47    36    58    53    50    72    66    
     37    50    45    36    58    54    50    72    66    
     37    51    45    36    56    54    50    72    66    
     37    51    46    35    58    54    50    147   66    

C1   40    54    47    67    88    64    129   146   86    
     40    54    47    67    88    64    128   146   84    
     40    54    49    67    88    64    128   146   86    
     40    54    47    67    88    64    128   108   86    

bg   37    51    45    36    58    54    50    72    64    
     37    51    45    36    58    54    50    72    66    
     37    51    45    34    58    54    50    72    66    
     37    51    45    36    58    54    50    72    66    

C2   40    55    48    54    102   84    99    192   136   
     40    55    48    54    100   84    99    192   136   
     40    55    48    53    102   85    99    192   136   
     40    55    48    54    102   85    99    192   136   

bg   37    51    46    36    58    54    51    71    66    
     37    49    46    35    58    54    50    72    65    
     37    51    46    36    58    54    50    72    66    
     37    50    46    36    59    54    50    109   64    

C3   39    52    49    39    80    88    56    125   150   
     39    54    51    39    80    88    56    125   150   
     39    54    49    39    80    88    56    124   150   
     39    54    49    39    80    88    56    72    150   

bg   37    51    46    36    58    54    50    70    66    
     37    51    46    36    58    54    50    72    66    
     37    50    46    36    58    54    51    72    66    
     38    51    46    34    58    54    50    74    66    

