Trial #1-------------------------

     A1    A2    A3    B1    B2    B3    C1    C2    C3    

A1   1189   1109   284   479   471   133   66    53    32    
     1186   1107   283   478   470   133   66    52    32    
     1182   1104   282   476   469   133   66    52    32    
     1178   1101   282   475   467   132   66    52    32    

bg   1     1     1     1     1     1     1     1     0     
     1     1     1     1     1     1     1     1     0     
     1     1     1     1     1     1     1     1     0     
     1     1     1     1     1     1     1     1     0     

A2   718   1758   1063   300   734   451   49    69    58    
     718   1757   1062   300   733   451   48    69    58    
     718   1755   1061   300   732   450   49    69    58    
     717   1753   1060   299   731   450   48    69    58    

bg   1     1     1     1     1     1     1     1     0     
     1     1     1     1     1     1     1     1     0     
     1     1     1     1     1     1     1     1     0     
     1     1     1     1     1     1     1     1     0     

A3   104   795   1286   49    355   481   22    40    67    
     104   794   1285   49    355   481   22    40    67    
     104   793   1284   50    354   481   22    40    67    
     104   794   1283   50    355   480   22    40    67    

bg   1     1     1     1     1     1     1     0     0     
     1     1     1     1     1     1     1     0     0     
     1     1     1     1     1     1     1     1     0     
     1     1     1     1     1     1     1     1     0     

B1   467   446   122   1144   1031   263   508   459   136   
     467   447   122   1143   1030   263   508   458   136   
     467   447   122   1142   1029   263   507   457   136   
     467   446   123   1140   1028   263   507   456   136   

bg   1     1     1     1     1     1     1     0     0     
     1     1     1     1     1     1     1     0     0     
     1     1     1     1     1     1     1     1     0     
     3     1     1     4     1     1     4     1     1     

B2   318   724   459   666   1811   1101   299   639   449   
     318   724   459   665   1809   1100   299   638   449   
     319   724   460   665   1807   1098   299   637   448   
     319   724   460   665   1805   1097   299   636   448   

bg   4     1     1     4     1     1     4     1     1     
     4     1     1     4     1     1     4     1     1     
     4     1     1     4     1     1     4     1     1     
     4     1     1     4     1     1     4     1     1     

B3   62    360   512   100   869   1331   70    391   611   
     62    360   512   100   869   1329   70    390   610   
     62    360   512   100   869   1326   70    390   609   
     62    360   512   100   867   1325   71    390   609   

bg   4     1     1     5     1     1     5     1     1     
     4     1     1     5     1     1     5     1     1     
     4     1     1     5     1     1     5     1     1     
     4     1     1     5     1     1     5     1     1     

C1   57    56    31    503   466   161   1264   1171   311   
     58    57    31    504   466   161   1263   1170   310   
     58    57    31    503   466   161   1262   1168   310   
     58    57    31    503   466   161   1261   1168   310   

bg   5     1     1     5     1     1     6     1     1     
     5     1     1     5     1     1     6     1     1     
     4     1     1     6     1     1     4     1     1     
     4     1     1     4     1     1     3     1     1     

C2   41    64    47    301   694   494   794   1910   1128   
     41    64    47    302   694   494   794   1908   1127   
     41    64    47    302   694   494   794   1906   1126   
     41    64    47    302   694   494   794   1904   1126   

bg   3     1     1     3     1     1     3     1     1     
     3     1     1     3     1     1     3     1     1     
     2     1     1     3     1     1     3     1     1     
     3     1     1     3     1     1     3     1     1     

C3   24    42    56    49    338   536   94    817   1331   
     24    42    56    49    338   536   93    817   1330   
     23    42    56    48    338   536   92    817   1329   
     23    42    56    48    339   537   92    817   1328   

bg   1     1     1     1     1     1     1     0     0     
     1     1     1     1     1     1     1     0     0     
     1     1     1     1     1     1     1     0     0     
     1     1     1     1     1     1     1     0     0     


Trial #2-------------------------

     A1    A2    A3    B1    B2    B3    C1    C2    C3    

A1   1190   1111   284   479   472   133   66    53    32    
     1187   1108   284   478   471   133   66    53    32    
     1182   1106   283   476   469   133   66    52    32    
     1179   1103   283   475   468   133   66    52    32    

bg   1     1     1     1     1     1     1     1     0     
     1     1     1     1     1     1     1     1     0     
     1     1     1     1     1     1     1     1     0     
     1     1     1     1     1     1     1     1     0     

A2   720   1761   1065   301   735   452   48    69    58    
     720   1760   1064   300   734   452   48    69    58    
     719   1759   1063   300   734   451   48    69    58    
     719   1756   1062   300   733   451   48    69    58    

bg   1     1     1     1     1     1     1     0     0     
     1     1     1     1     1     1     1     0     0     
     1     1     1     1     1     1     1     1     0     
     1     1     1     1     1     1     1     0     0     

A3   104   795   1287   49    355   481   22    40    67    
     104   795   1285   49    355   481   22    40    67    
     104   794   1284   50    355   481   22    40    67    
     104   793   1283   50    355   480   22    40    67    

bg   1     1     1     1     1     1     1     0     0     
     1     1     1     1     1     1     1     0     0     
     1     1     1     1     1     1     1     1     0     
     1     1     1     1     1     1     1     0     0     

B1   468   448   123   1146   1034   264   509   459   136   
     468   447   123   1144   1032   264   508   458   136   
     468   448   123   1143   1031   264   508   457   136   
     468   447   123   1142   1029   264   508   457   136   

bg   1     1     1     1     1     1     1     1     0     
     1     1     1     1     1     1     1     0     0     
     1     1     1     1     1     1     1     1     0     
     1     1     1     1     1     1     1     1     0     

B2   316   724   459   663   1812   1101   296   639   449   
     317   724   460   662   1809   1100   296   638   449   
     317   724   460   662   1805   1099   296   637   448   
     317   724   460   661   1804   1097   296   637   448   

bg   1     1     1     1     1     1     1     0     0     
     1     1     1     1     1     1     1     1     0     
     1     1     1     1     1     1     1     1     0     
     1     1     1     1     1     1     1     0     0     

B3   59    360   513   96    870   1332   67    392   612   
     59    360   513   97    870   1331   67    391   611   
     59    361   513   97    870   1329   67    391   610   
     59    361   513   97    869   1328   67    391   609   

bg   1     1     1     1     1     1     1     1     0     
     1     1     1     1     1     1     1     0     0     
     1     1     1     1     1     1     1     1     0     
     1     1     1     1     1     1     1     1     0     

C1   54    56    31    501   467   161   1263   1174   311   
     54    56    30    500   467   162   1261   1173   311   
     54    56    30    500   467   162   1260   1171   311   
     54    56    30    500   467   162   1259   1169   311   

bg   1     1     1     1     1     1     1     1     0     
     1     1     1     1     1     1     1     1     0     
     1     1     1     1     1     1     1     0     0     
     1     1     1     1     1     1     1     0     0     

C2   39    63    47    297   688   490   786   1895   1119   
     39    63    47    297   688   491   785   1893   1119   
     39    63    47    297   688   491   785   1890   1117   
     39    63    47    298   688   491   785   1890   1117   

bg   1     1     1     1     1     1     1     0     0     
     1     1     1     1     1     1     1     1     0     
     1     1     1     1     1     1     1     1     0     
     1     1     1     1     1     1     1     0     0     

C3   23    42    57    48    339   538   92    820   1335   
     23    42    57    48    340   539   93    820   1337   
     23    42    57    48    340   538   93    819   1333   
     23    42    57    48    340   539   93    819   1332   

bg   1     1     1     1     1     1     1     1     0     
     1     1     1     1     1     1     1     1     0     
     3     1     1     4     1     1     4     1     1     
     3     1     1     4     1     1     4     1     1     


Trial #3-------------------------

     A1    A2    A3    B1    B2    B3    C1    C2    C3    

A1   1184   1103   282   478   468   132   69    52    32    
     1181   1101   282   477   467   132   69    52    32    
     1175   1098   281   476   466   132   69    52    32    
     1172   1094   280   474   465   132   68    52    32    

bg   4     1     1     4     1     1     4     1     1     
     4     1     1     4     1     1     4     1     1     
     4     1     1     4     1     1     4     1     1     
     4     1     1     4     1     1     4     1     1     

A2   715   1749   1058   299   730   449   49    69    58    
     715   1747   1057   299   729   448   49    69    58    
     714   1745   1055   299   728   448   49    68    58    
     714   1745   1054   298   727   448   49    68    58    

bg   2     1     1     2     1     1     2     1     0     
     2     1     1     2     1     1     2     1     0     
     2     1     1     2     1     1     2     1     0     
     2     1     1     2     1     1     2     1     0     

A3   105   796   1288   51    355   482   23    40    67    
     105   796   1287   51    355   482   23    40    67    
     105   796   1286   51    356   481   23    40    67    
     105   795   1285   51    356   481   23    40    67    

bg   2     1     1     2     1     1     2     1     0     
     2     1     1     2     1     1     2     1     0     
     2     1     1     2     1     1     2     1     0     
     2     1     1     2     1     1     2     1     0     

B1   471   450   123   1151   1037   265   512   460   137   
     471   450   123   1149   1035   265   511   460   137   
     471   450   123   1149   1035   265   511   459   137   
     471   449   123   1147   1034   265   510   458   137   

bg   2     1     1     2     1     1     2     1     0     
     2     1     1     2     1     1     2     1     0     
     2     1     1     2     1     1     2     1     0     
     2     1     1     2     1     1     2     1     0     

B2   318   726   461   665   1815   1104   298   640   450   
     318   722   459   665   1807   1102   297   638   448   
     317   725   459   663   1802   1097   297   636   447   
     318   723   459   661   1800   1095   297   635   447   

bg   2     1     1     2     1     1     2     1     0     
     2     1     1     2     1     1     2     1     0     
     2     1     1     2     1     1     2     1     0     
     2     1     1     2     1     1     2     1     0     

B3   60    361   515   98    873   1336   68    393   613   
     60    362   515   98    873   1333   68    393   613   
     60    362   515   98    872   1331   68    392   612   
     60    362   515   98    871   1330   68    392   611   

bg   2     1     1     2     1     1     2     1     0     
     1     1     1     1     1     1     1     1     0     
     1     1     1     1     1     1     1     1     0     
     1     1     1     1     1     1     1     1     0     

C1   55    57    31    503   469   162   1268   1178   312   
     55    57    31    503   468   162   1265   1174   312   
     55    57    31    503   469   162   1265   1175   312   
     55    57    31    502   469   162   1263   1173   312   

bg   1     1     1     1     1     1     1     1     0     
     1     1     1     1     1     1     1     1     0     
     1     1     1     1     1     1     1     1     0     
     1     1     1     1     1     1     1     1     0     

C2   39    64    47    298   690   491   788   1897   1121   
     39    64    47    299   690   491   788   1896   1121   
     39    64    47    299   690   492   788   1894   1120   
     39    64    47    299   690   492   787   1893   1119   

bg   1     1     1     1     1     1     1     1     0     
     1     1     1     1     1     1     1     1     0     
     1     1     1     1     1     1     1     1     0     
     1     1     1     1     1     1     1     1     0     

C3   23    42    56    48    337   534   92    813   1325   
     23    42    56    48    337   534   92    813   1324   
     23    42    56    48    337   534   92    813   1323   
     23    42    56    48    338   534   93    813   1322   

bg   1     1     1     1     1     1     1     1     0     
     1     1     1     1     1     1     1     1     0     
     1     1     1     1     1     1     1     1     0     
     1     1     1     1     1     1     1     1     0     


Trial #4-------------------------

     A1    A2    A3    B1    B2    B3    C1    C2    C3    

A1   1185   1105   283   477   469   133   66    52    32    
     1180   1103   282   476   468   132   66    52    32    
     1176   1099   281   473   467   132   66    52    32    
     1172   1096   281   472   465   132   66    52    32    

bg   1     1     1     1     1     1     1     1     0     
     1     1     1     1     1     1     1     1     0     
     1     1     1     1     1     1     1     1     0     
     1     1     1     1     1     1     1     1     0     

A2   717   1753   1061   299   732   450   48    69    58    
     717   1752   1058   299   731   450   48    69    58    
     716   1751   1058   299   730   449   48    69    58    
     716   1750   1057   299   730   449   48    69    58    

bg   1     1     1     1     1     1     1     1     0     
     1     1     1     1     1     1     1     1     0     
     1     1     1     1     1     1     1     1     0     
     1     1     1     1     1     1     1     1     0     

A3   105   798   1291   50    356   483   23    41    67    
     105   797   1289   50    356   482   23    40    67    
     105   796   1287   50    356   482   23    40    67    
     105   796   1286   50    356   482   23    40    67    

bg   1     1     1     1     1     1     1     1     0     
     1     1     1     1     1     1     1     1     0     
     1     1     1     1     1     1     1     1     0     
     1     1     1     1     1     1     1     1     0     

B1   472   451   124   1154   1041   266   513   462   137   
     472   451   124   1152   1039   266   512   461   137   
     472   451   124   1150   1038   266   512   460   137   
     472   450   124   1149   1036   265   511   459   137   

bg   1     1     1     1     1     1     1     1     0     
     1     1     1     1     1     1     1     1     0     
     1     1     1     1     1     1     1     1     0     
     1     1     1     1     1     1     1     1     0     

B2   318   726   461   665   1816   1104   297   640   450   
     318   726   462   665   1812   1102   298   639   450   
     318   726   461   664   1808   1101   297   638   449   
     318   726   460   662   1806   1097   297   638   448   

bg   1     1     1     1     1     1     1     1     0     
     1     1     1     1     1     1     1     1     0     
     1     1     1     1     1     1     1     0     0     
     1     1     1     1     1     1     1     1     0     

B3   59    362   516   97    874   1337   67    393   614   
     59    362   516   97    874   1335   67    393   613   
     60    363   516   97    873   1334   67    392   613   
     60    363   516   97    873   1332   67    392   612   

bg   1     1     1     1     1     1     1     1     0     
     1     1     1     1     1     1     1     1     0     
     1     1     1     1     1     1     1     0     0     
     1     1     1     1     1     1     1     0     0     

C1   55    57    31    504   470   163   1270   1180   313   
     55    57    31    504   470   163   1269   1178   313   
     55    57    31    503   470   163   1267   1177   313   
     55    57    31    503   470   163   1265   1175   312   

bg   1     1     1     1     1     1     1     1     0     
     1     1     1     1     1     1     1     1     0     
     1     1     1     1     1     1     1     1     0     
     1     1     1     1     1     1     1     1     0     

C2   40    64    47    300   692   493   791   1903   1124   
     40    64    47    300   692   493   791   1901   1123   
     40    64    47    300   692   493   790   1900   1122   
     40    64    47    300   691   493   790   1895   1121   

bg   2     1     1     2     1     1     2     1     0     
     2     1     1     2     1     1     2     1     0     
     2     1     1     2     1     1     2     1     0     
     2     1     1     2     1     1     2     1     0     

C3   24    42    56    48    337   536   93    815   1328   
     24    42    56    49    338   535   93    815   1327   
     24    42    56    49    338   535   93    815   1326   
     24    42    56    49    339   535   93    815   1325   

bg   2     1     1     2     1     1     2     1     0     
     2     1     1     2     1     1     2     1     0     
     2     1     1     2     1     1     2     1     0     
     2     1     1     2     1     1     2     1     0     


