    A1   A2   A3   B1   B2   B3   C1   C2   C3   
bg  355  528  394  379  577  424  375  522  393  
    354  528  394  379  577  424  375  523  392  
    354  527  394  379  578  424  375  522  392  
    354  527  394  379  577  424  375  522  392  
    
A1  421  587  409  407  603  431  380  526  395  
    421  589  409  407  603  431  380  526  395  
    421  588  409  407  603  431  380  525  394  
    420  589  409  407  603  431  380  525  395  
    
A2  390  636  461  394  616  448  378  527  396  
    391  636  460  394  616  448  378  526  396  
    391  635  460  393  616  448  378  528  396  
    390  636  460  394  616  448  378  526  396  
    
A3  360  580  477  383  599  454  377  525  396  
    360  581  476  383  599  454  377  528  397  
    359  580  476  382  599  454  377  525  397  
    359  581  476  383  598  454  377  525  397  
    
B1  381  552  401  453  641  439  408  552  400  
    382  553  400  453  641  439  408  551  401  
    381  552  400  453  641  439  408  551  401  
    382  552  401  453  641  439  408  551  400  
    
B2  372  572  421  422  693  492  396  565  420  
    371  571  421  422  693  492  396  567  420  
    372  570  422  421  693  492  396  565  420  
    372  571  421  422  693  492  397  566  420  
    
B3  356  546  421  383  627  503  380  549  429  
    356  547  421  384  626  503  380  548  429  
    356  546  421  384  627  503  380  551  429  
    356  546  421  384  627  503  380  548  428  
    
C1  357  530  396  412  610  435  457  597  415  
    357  531  396  412  610  435  458  596  414  
    357  531  397  412  610  435  457  597  415  
    358  530  396  412  610  435  457  597  415  
    
C2  356  531  396  395  615  450  420  629  456  
    356  531  396  394  616  450  420  631  456  
    357  531  397  395  616  450  420  629  456  
    356  531  396  395  616  450  420  630  456  
    
C3  355  530  397  381  599  456  383  575  470  
    355  530  397  383  598  456  383  575  470  
    355  529  397  383  599  456  383  575  470  
    355  530  397  382  599  456  383  575  470  
    
