    A1   A2   A4   B1   B2   C4   C1   D3   C3   
bg  355  528  394  380  578  425  377  525  393  
    354  528  394  380  578  425  376  523  393  
    355  528  395  380  578  425  376  523  393  
    354  528  395  380  578  424  376  523  393  
    
A1  421  589  409  408  604  431  380  526  395  
    422  590  409  408  604  431  380  526  395  
    421  589  409  407  604  431  380  526  395  
    421  589  409  407  604  431  380  526  395  
    
A2  391  637  460  394  616  448  378  528  396  
    391  636  460  394  616  448  378  527  396  
    391  636  460  394  616  448  378  526  396  
    392  635  460  394  616  448  378  527  396  
    
A4  360  581  476  382  600  455  377  526  398  
    360  581  476  383  599  455  377  525  397  
    360  581  476  383  600  454  377  525  397  
    360  581  476  383  600  455  377  528  397  
    
B1  382  553  400  453  641  439  409  551  401  
    382  552  401  453  642  440  409  551  401  
    382  553  400  453  642  440  409  552  401  
    382  552  400  453  642  440  409  551  401  
    
B2  372  572  421  422  693  493  397  566  421  
