    A1   A2   A3   B1   B2   B3   C1   C2   C3   
bg  354  527  393  379  577  426  376  522  396  
    354  527  393  379  577  426  376  521  396  
    354  527  393  379  577  426  376  521  396  
    354  527  394  379  577  426  376  522  397  
    
A1  420  588  408  407  603  432  380  525  398  
    421  588  408  407  603  432  380  525  398  
    420  588  408  407  603  432  380  525  398  
    420  588  408  407  603  433  380  525  398  
    
A2  390  636  459  394  615  449  378  525  399  
    390  636  459  394  616  450  379  525  399  
    390  636  459  394  616  450  378  525  399  
    391  636  459  393  616  449  378  525  399  
    
A3  359  580  476  381  599  456  377  525  400  
    359  580  475  382  599  456  377  524  401  
    360  580  475  382  599  456  377  524  400  
    359  580  476  382  599  456  377  525  400  
    
B1  381  552  400  453  641  441  409  550  404  
    381  552  399  453  641  441  409  551  404  
    382  551  399  453  641  441  409  550  404  
    382  552  399  453  641  441  408  550  404  
    
B2  371  571  420  422  693  494  396  565  424  
    372  570  421  422  693  494  396  565  423  
    371  571  420  421  693  494  396  565  424  
    372  571  420  422  693  494  396  567  424  
    
B3  356  546  420  384  627  505  380  548  433  
    356  546  420  384  627  505  380  548  433  
    356  546  420  384  627  504  380  548  432  
    356  545  420  384  627  505  380  548  432  
    
C1  357  531  395  411  609  437  457  596  418  
    357  531  395  412  610  437  457  598  418  
    357  531  395  412  609  437  457  595  418  
    357  531  395  411  610  437  457  596  418  
    
C2  356  531  396  395  615  451  420  630  460  
    356  530  396  395  615  451  420  629  460  
    356  530  396  395  615  451  420  628  460  
    356  530  396  395  615  452  420  629  460  
    
C3  355  530  396  382  598  458  383  574  474  
    355  530  396  382  598  458  382  574  474  
    355  530  397  382  598  458  382  575  473  
    355  530  396  382  598  458  382  576  474  
    
