    A1   A2   A3   B1   B2   B3   C1   C2   C3   
bg  354  528  394  379  578  424  375  523  393  
    354  527  394  379  578  424  376  522  393  
    354  528  394  379  578  424  375  523  393  
    354  528  394  379  578  424  375  522  393  
    
A1  421  589  409  408  604  431  380  525  395  
    421  589  409  407  603  431  380  526  394  
    421  589  409  407  604  431  380  526  395  
    421  588  409  407  604  431  380  525  395  
    
A2  391  636  460  394  616  448  378  526  396  
    390  636  460  394  616  448  378  526  396  
    390  635  460  394  616  448  379  526  395  
    391  636  460  394  616  448  378  528  396  
    
A3  359  579  476  383  599  454  377  525  397  
    359  580  476  382  599  454  377  525  397  
    360  580  476  383  599  454  377  525  397  
    359  580  476  382  598  454  377  525  397  
    
B1  381  552  400  453  641  439  408  551  400  
    381  553  401  453  641  439  408  551  400  
    382  552  400  453  641  439  408  553  400  
    381  553  400  453  641  439  408  551  401  
    
B2  371  571  421  422  693  492  396  566  420  
    372  571  422  422  693  492  396  567  419  
    371  571  421  422  693  492  396  565  420  
    372  571  421  422  693  492  396  565  420  
    
B3  356  546  421  384  627  503  380  548  429  
    356  546  421  384  627  503  380  548  429  
    356  546  421  384  627  503  380  548  429  
    356  546  421  384  626  503  380  548  429  
    
C1  357  531  396  412  610  435  457  598  415  
    357  531  396  412  610  435  457  597  415  
    358  531  396  412  609  435  457  597  415  
    357  530  396  412  610  435  457  597  415  
    
C2  356  531  397  394  616  450  420  630  456  
    356  530  396  395  616  450  421  631  456  
    356  531  396  395  616  450  420  629  457  
    357  531  397  395  616  450  420  629  456  
    
C3  355  530  398  382  599  457  383  577  470  
    355  530  397  382  599  457  382  575  471  
    355  530  397  382  599  457  383  576  470  
    355  530  397  383  599  456  382  576  470  
    
