Trial #9-------------------------

     A1    A2    A3    B1    B2    B3    C1    C2    C3    

A1   1739   1882   1004   1031   1400   1002   874   1218   1122   
     1735   1878   1002   1030   1375   1000   873   1217   1120   
     1747   1875   1001   1028   1396   999   883   1213   1089   
     1727   1871   1001   1005   1367   998   871   1198   1119   

bg   602   817   732   548   945   872   808   1161   1086   
     601   816   731   572   945   870   825   1160   1061   
     601   815   730   572   926   871   806   1159   1084   
     600   815   758   549   943   869   805   1178   1083   

A2   1287   2502   1753   838   1644   1298   850   1222   1136   
     1287   2508   1749   857   1641   1297   850   1221   1134   
     1286   2502   1748   856   1641   1294   850   1220   1133   
     1285   2499   1745   856   1639   1293   849   1153   1131   

bg   601   811   724   568   923   863   807   1150   1074   
     597   810   724   568   937   861   800   1150   1073   
     597   768   724   567   936   862   800   1149   1057   
     613   809   723   566   935   861   816   1128   1073   

A3   694   1574   1994   611   1273   1322   817   1184   1134   
     694   1544   1973   611   1243   1320   817   1183   1132   
     693   1572   1969   611   1272   1319   817   1183   1132   
     693   1571   1966   611   1272   1317   817   1158   1131   

bg   601   807   721   566   933   858   818   1149   1047   
     596   808   722   545   935   859   799   1150   1070   
     609   809   745   567   936   861   800   1151   1072   
     597   775   723   567   936   861   800   1594   1073   

B1   1042   1235   837   1666   1929   1111   1283   1584   1199   
     1047   1235   843   1655   1926   1109   1281   1581   1197   
     1041   1235   835   1661   1924   1108   1280   1580   1195   
     1040   1234   835   1657   1921   1107   1278   1137   1194   

bg   591   801   715   553   901   851   791   1136   1060   
     591   801   715   560   925   850   790   1135   1059   
     591   801   714   560   925   850   809   1135   1058   
     591   801   714   560   925   849   790   1603   1057   

B2   893   1496   1155   1195   2668   1908   1073   1745   1462   
     892   1495   1153   1193   2661   1907   1086   1746   1486   
     894   1497   1155   1195   2667   1908   1072   1725   1487   
     907   1497   1155   1194   2663   1907   1072   1130   1487   

bg   588   798   712   557   921   846   785   1130   1054   
     588   798   712   557   921   846   786   1130   1054   
     588   798   712   543   921   847   786   1130   1054   
     588   798   712   557   909   846   787   1344   1054   

B3   663   1143   1227   649   1759   2129   850   1505   1639   
     644   1143   1202   650   1757   2125   859   1504   1638   
     644   1102   1203   648   1757   2125   850   1503   1637   
     644   1142   1203   649   1756   2122   859   1127   1609   

bg   585   795   708   555   917   842   782   1121   1045   
     584   768   716   534   915   840   780   1118   1046   
     583   791   705   552   912   839   778   1117   1044   
     582   790   704   551   911   837   777   1394   1041   

C1   633   845   760   1032   1363   993   2009   2252   1343   
     634   846   735   1034   1365   994   1994   2254   1344   
     649   848   737   1035   1366   996   1997   2255   1346   
     637   816   758   1036   1369   998   2016   1506   1348   

bg   589   798   712   558   923   847   788   1131   1054   
     607   798   712   558   922   847   787   1129   1054   
     588   797   729   557   920   847   786   1127   1053   
     587   796   710   552   895   844   784   1126   1026   

C2   622   855   753   840   1581   1315   1545   2951   2132   
     622   855   753   840   1581   1314   1539   2948   2130   
     622   855   752   841   1558   1314   1538   2942   2128   
     623   855   752   841   1579   1313   1538   2943   2123   

bg   600   795   708   555   917   841   783   1124   1047   
     587   778   708   555   917   841   783   1124   1046   
     586   794   708   532   917   841   783   1124   1047   
     597   794   708   555   916   841   782   1773   1046   

C3   606   833   760   599   1227   1361   869   1914   2340   
     606   833   760   598   1242   1361   869   1912   2340   
     605   832   760   598   1220   1361   885   1889   2337   
     605   795   759   598   1242   1360   868   1119   2333   

bg   584   785   705   552   913   838   779   1118   1043   
     584   791   731   550   882   837   797   1118   1042   
     584   752   704   553   913   837   779   1117   1031   
     584   791   704   552   896   837   779   1119   1041   


Trial #10-------------------------

     A1    A2    A3    B1    B2    B3    C1    C2    C3    

A1   1717   1852   973   1006   1360   962   838   1166   1070   
     1729   1852   973   1004   1359   962   838   1164   1037   
     1709   1847   974   1002   1357   962   837   1164   1070   
     1706   1844   972   1000   1356   961   836   1114   1070   

bg   581   788   702   549   909   835   775   1113   1038   
     581   788   725   549   909   834   775   1113   1038   
     581   788   702   550   908   834   775   1113   1037   
     581   788   701   534   908   833   791   1127   1037   

A2   1271   2488   1729   829   1587   1265   821   1177   1090   
     1271   2487   1727   836   1612   1264   820   1177   1090   
     1270   2485   1726   836   1610   1263   820   1177   1059   
     1288   2485   1754   836   1611   1264   820   1136   1090   

bg   580   787   701   548   907   833   793   1112   1037   
     581   787   701   548   908   833   774   1112   1013   
     581   788   702   529   908   834   774   1113   1037   
     581   788   702   549   908   834   774   1142   1037   

A3   680   1557   1954   596   1249   1296   796   1152   1100   
     680   1540   1952   597   1249   1295   796   1152   1099   
     681   1555   1950   597   1250   1294   797   1139   1099   
     681   1555   1949   597   1250   1294   797   1144   1100   

bg   583   789   719   551   911   835   777   1117   1040   
     586   790   703   551   911   836   778   1116   1040   
     582   790   704   551   911   836   777   1114   1027   
     582   751   703   550   910   835   776   1537   1038   

B1   1032   1215   820   1659   1913   1089   1265   1556   1168   
     1032   1222   820   1656   1908   1088   1278   1556   1168   
     1032   1184   842   1657   1907   1089   1265   1530   1168   
     1033   1223   820   1657   1907   1088   1265   1115   1168   

bg   582   789   702   525   910   834   777   1114   1011   
     590   789   708   550   909   834   776   1113   1037   
     581   788   701   550   907   833   775   1111   1036   
     593   788   701   528   907   832   774   1321   1035   

B2   882   1482   1140   1166   2651   1893   1055   1722   1464   
     882   1482   1141   1183   2650   1893   1063   1719   1464   
     885   1481   1159   1181   2645   1887   1053   1715   1462   
     881   1480   1137   1181   2615   1884   1063   1230   1459   

bg   577   783   696   545   901   826   769   1105   1027   
     578   783   697   546   903   827   770   1106   1029   
     579   785   698   538   904   828   771   1108   1030   
     579   786   698   548   905   829   773   1488   1031   

B3   636   1133   1195   641   1747   2122   853   1487   1600   
     636   1133   1195   640   1746   2120   837   1486   1624   
     642   1105   1195   640   1746   2120   837   1486   1597   
     636   1134   1196   640   1741   2119   850   1241   1623   

bg   580   787   701   548   907   832   773   1110   1035   
     580   776   701   530   907   832   774   1102   1035   
     581   787   700   548   885   832   774   1111   1035   
     581   787   700   549   907   832   774   2134   1035   

C1   630   841   729   1026   1354   985   1981   2234   1332   
     648   840   740   1022   1323   985   1980   2232   1333   
     630   840   728   1025   1353   985   1977   2209   1332   
     630   800   728   1018   1337   985   1975   1916   1301   

bg   595   774   728   531   906   832   773   1111   1035   
     580   787   701   548   906   832   773   1111   1035   
     580   787   701   548   907   832   773   1111   1013   
     580   787   722   524   907   832   774   1085   1036   

C2   617   848   745   811   1572   1302   1529   2933   2114   
     617   848   744   834   1549   1302   1528   2940   2111   
     618   848   753   836   1573   1304   1534   2938   2116   
     618   848   745   836   1573   1306   1533   2937   2115   

bg   581   788   701   549   880   833   775   1112   1023   
     581   788   701   549   908   833   792   1112   1037   
     600   788   702   542   882   833   774   1112   1037   
     581   788   722   549   908   834   774   1460   1025   

C3   602   827   754   594   1233   1349   862   1898   2322   
     602   827   754   594   1234   1349   863   1900   2319   
     602   827   754   594   1234   1348   863   1898   2317   
     602   828   754   595   1235   1349   864   1219   2315   

bg   582   788   701   550   908   833   775   1113   1036   
     581   788   701   525   908   833   775   1112   1008   
     581   771   701   549   908   833   775   1112   1036   
     581   788   701   549   908   833   791   1162   1036   


Trial #11-------------------------

     A1    A2    A3    B1    B2    B3    C1    C2    C3    

A1   1724   1854   974   1004   1358   960   835   1163   1068   
     1711   1850   972   985   1356   960   836   1163   1069   
     1708   1845   972   1001   1355   961   836   1154   1069   
     1705   1844   971   999   1355   961   836   1132   1068   

bg   582   789   702   550   901   834   795   1114   1038   
     582   783   702   550   909   833   776   1094   1037   
     582   789   715   550   909   834   776   1113   1037   
     582   749   702   550   909   834   776   1151   1037   

A2   1273   2473   1732   838   1615   1267   821   1179   1093   
     1272   2489   1757   837   1613   1267   821   1179   1070   
     1285   2487   1730   837   1612   1266   820   1155   1093   
     1272   2487   1728   836   1612   1267   820   1163   1093   

bg   582   789   703   550   910   835   776   1115   1039   
     582   789   703   550   910   835   777   1115   1039   
     582   789   703   531   910   835   777   1114   1039   
     582   789   708   551   910   834   777   1102   1038   

A3   680   1553   1947   597   1248   1293   797   1152   1100   
     680   1552   1946   597   1248   1293   811   1152   1100   
     681   1552   1947   591   1249   1293   797   1153   1101   
     681   1551   1945   597   1249   1294   797   1121   1102   

bg   583   790   704   551   911   836   777   1116   1041   
     582   790   704   536   911   837   777   1117   1042   
     583   790   704   551   911   836   778   1117   1042   
     597   762   704   551   899   837   778   1560   1042   

B1   1031   1193   848   1654   1907   1090   1268   1559   1143   
     1031   1222   822   1650   1903   1091   1270   1560   1173   
     1033   1213   823   1650   1879   1091   1267   1559   1173   
     1032   1222   823   1648   1902   1091   1280   1120   1173   

bg   604   793   706   553   914   839   780   1121   1044   
     584   793   708   553   914   839   780   1117   1045   
     586   792   707   553   914   840   780   1121   1046   
     584   794   707   547   913   840   780   1726   1046   

B2   887   1489   1170   1188   2655   1899   1065   1737   1477   
     890   1480   1149   1191   2660   1902   1067   1738   1479   
     891   1492   1150   1191   2658   1901   1068   1717   1479   
     891   1493   1162   1191   2658   1901   1081   1489   1478   

bg   586   795   708   555   917   841   783   1124   1024   
     586   795   708   555   896   841   783   1125   1047   
     597   795   736   531   917   841   783   1125   1019   
     586   795   708   555   917   843   783   1441   1049   

B3   642   1139   1201   647   1723   2127   847   1499   1637   
     642   1139   1200   647   1750   2121   847   1499   1636   
     643   1140   1200   647   1729   2119   847   1472   1635   
     644   1140   1200   647   1750   2118   847   1128   1634   

bg   588   798   711   557   921   845   787   1131   1052   
     589   799   712   558   922   846   788   1132   1053   
     590   799   712   559   923   847   788   1133   1054   
     590   800   713   559   924   848   789   1714   1024   

C1   653   854   743   1035   1355   1002   1991   2254   1355   
     639   854   743   1035   1369   1003   1986   2253   1355   
     639   854   743   1034   1370   1003   1985   2251   1332   
     650   836   744   1034   1369   1004   1985   1202   1356   

bg   591   771   716   561   927   852   792   1139   1061   
     592   803   739   561   899   853   811   1139   1062   
     592   803   717   562   928   853   793   1140   1062   
     593   804   717   542   929   853   794   1141   1063   

C2   631   866   768   837   1593   1329   1557   2980   2137   
     631   866   764   851   1598   1331   1557   2977   2153   
     648   860   764   852   1599   1331   1556   2973   2152   
     631   867   765   852   1599   1332   1556   2974   2142   

bg   596   808   722   566   935   860   798   1149   1072   
     610   790   723   566   935   860   799   1138   1073   
     596   810   724   555   936   861   800   1152   1073   
     597   810   724   567   937   862   817   1924   1074   

C3   620   852   779   614   1266   1380   892   1945   2362   
     621   853   780   615   1268   1382   893   1947   2329   
     622   854   781   616   1270   1384   894   1927   2363   
     622   856   808   617   1272   1386   896   1574   2366   

bg   606   821   735   575   950   875   812   1170   1067   
     605   822   736   576   952   877   814   1172   1094   
     606   823   737   577   953   878   814   1174   1095   
     623   823   738   577   954   879   815   1191   1096   


Trial #12-------------------------

     A1    A2    A3    B1    B2    B3    C1    C2    C3    

A1   1744   1890   1011   1034   1407   1008   879   1230   1130   
     1742   1889   1011   1032   1407   1010   880   1232   1133   
     1740   1889   1012   1034   1408   1011   882   1205   1135   
     1739   1887   1012   1034   1395   1013   883   1188   1137   

bg   626   832   763   585   965   890   826   1191   1111   
     614   810   747   586   966   891   827   1191   1098   
     614   834   748   586   967   893   827   1192   1113   
     614   815   749   561   968   894   828   1224   1083   

A2   1298   2491   1771   850   1668   1324   874   1261   1173   
     1299   2521   1771   873   1668   1324   889   1261   1174   
     1300   2521   1791   873   1668   1325   876   1262   1174   
     1299   2520   1768   873   1668   1326   876   1205   1174   

bg   618   838   753   591   974   899   834   1201   1122   
     618   839   757   591   974   899   834   1201   1122   
     618   835   754   591   970   899   834   1201   1122   
     618   839   754   591   974   899   834   1237   1122   

A3   716   1603   2001   637   1313   1360   854   1240   1187   
     729   1602   2001   637   1291   1360   865   1240   1188   
     716   1602   2000   638   1313   1360   854   1228   1187   
     726   1601   1997   638   1286   1360   863   1223   1176   

bg   619   840   755   592   975   901   835   1202   1125   
     619   840   755   569   975   901   835   1182   1124   
     619   840   755   592   961   901   835   1204   1124   
     620   829   755   593   976   901   836   1627   1125   

B1   1069   1242   876   1697   1976   1160   1328   1650   1262   
     1069   1274   876   1683   1972   1160   1326   1646   1229   
     1067   1272   875   1693   1969   1157   1323   1616   1259   
     1065   1269   873   1687   1965   1155   1340   1201   1255   

bg   617   838   753   585   953   898   831   1197   1121   
     616   837   752   589   971   897   831   1195   1120   
     616   836   751   589   971   896   831   1195   1119   
     616   836   750   574   970   895   830   1570   1118   

B2   918   1530   1189   1199   2704   1952   1114   1811   1548   
     920   1511   1208   1223   2679   1951   1116   1811   1550   
     921   1532   1192   1224   2706   1952   1116   1789   1522   
     920   1532   1192   1223   2704   1948   1116   1196   1550   

bg   614   803   772   586   967   892   827   1191   1114   
     629   833   748   586   966   892   826   1193   1099   
     614   834   749   586   967   893   827   1194   1115   
     614   834   771   587   968   894   828   1380   1116   

B3   666   1171   1232   673   1793   2166   884   1553   1690   
     664   1170   1230   672   1791   2161   882   1550   1686   
     663   1168   1237   669   1790   2158   881   1549   1683   
     663   1169   1229   671   1788   2151   880   1209   1680   

bg   607   824   738   578   928   880   816   1175   1097   
     607   824   738   560   955   880   833   1175   1097   
     607   824   738   578   955   880   815   1176   1097   
     626   824   739   578   955   881   815   2304   1098   

C1   658   880   770   1057   1406   1039   2023   2308   1402   
     658   882   772   1035   1407   1040   2023   2305   1405   
     675   881   771   1057   1407   1041   2023   2290   1404   
     658   862   769   1057   1406   1038   2022   1671   1401   

bg   607   793   738   578   955   880   816   1176   1068   
     607   824   738   578   955   880   816   1155   1097   
     607   825   739   579   956   880   817   1178   1098   
     608   826   740   579   936   882   833   1158   1100   

C2   647   889   789   866   1623   1356   1574   3006   2183   
     660   891   789   867   1624   1358   1576   3007   2186   
     649   886   791   869   1627   1360   1583   2981   2187   
     649   893   792   870   1627   1362   1579   3005   2187   

bg   621   835   750   587   970   894   829   1195   1116   
     616   819   751   588   970   895   830   1197   1093   
     616   836   763   565   971   896   830   1196   1118   
     616   836   751   588   971   895   834   1750   1089   

C3   639   878   807   635   1300   1415   921   1991   2404   
     640   880   837   637   1303   1420   924   1995   2412   
     642   884   811   625   1297   1425   926   2001   2412   
     645   887   816   642   1311   1427   931   1219   2419   

bg   627   853   769   601   992   918   849   1228   1147   
     629   854   770   599   995   920   851   1231   1150   
     644   856   772   604   996   922   853   1233   1152   
     631   858   788   605   971   924   854   1234   1153   

