Trial #9-------------------------

     A1    A2    A3    B1    B2    B3    C1    C2    C3    

A1   1773   1926   1038   1062   1447   1043   912   1277   1174   
     1786   1919   1058   1059   1444   1040   919   1273   1171   
     1762   1900   1032   1056   1440   1038   907   1270   1168   
     1758   1910   1029   1053   1407   1035   914   1268   1165   

bg   642   846   757   598   986   906   843   1215   1129   
     625   846   757   598   986   905   844   1215   1129   
     625   846   757   598   987   905   844   1216   1129   
     625   846   783   599   987   905   844   1215   1103   

A2   1319   2554   1791   886   1693   1339   886   1277   1183   
     1317   2552   1790   884   1691   1339   885   1276   1183   
     1317   2551   1789   884   1691   1339   885   1277   1177   
     1317   2536   1790   865   1685   1340   903   1278   1186   

bg   624   816   760   586   987   909   842   1216   1133   
     625   847   760   598   987   908   843   1216   1123   
     643   842   760   598   966   907   844   1217   1132   
     626   848   760   599   988   907   844   1217   1131   

A3   725   1619   2020   646   1330   1371   883   1255   1164   
     726   1621   2015   646   1304   1371   865   1255   1195   
     725   1619   2015   628   1331   1371   864   1255   1195   
     725   1617   2014   646   1300   1372   877   1255   1196   

bg   625   848   761   598   988   910   843   1202   1135   
     625   844   761   598   988   910   843   1217   1135   
     625   848   775   598   987   910   843   1217   1135   
     625   848   761   598   988   909   843   1217   1134   

B1   1081   1283   879   1715   1995   1163   1349   1663   1264   
     1082   1284   906   1715   1993   1163   1338   1663   1240   
     1083   1284   878   1714   1992   1163   1338   1662   1263   
     1081   1282   878   1710   1988   1162   1336   1660   1262   

bg   625   847   759   598   973   907   843   1215   1131   
     624   846   759   597   986   907   842   1214   1132   
     624   815   764   597   965   907   841   1214   1132   
     624   846   778   575   986   907   841   1214   1132   

B2   948   1545   1202   1213   2737   1971   1126   1830   1565   
     929   1523   1202   1236   2709   1969   1127   1829   1563   
     930   1546   1201   1236   2733   1967   1128   1829   1562   
     930   1545   1201   1215   2729   1963   1128   1827   1559   

bg   624   844   756   582   958   903   841   1210   1125   
     623   844   757   596   983   903   845   1210   1126   
     623   844   757   596   972   903   840   1210   1126   
     623   813   784   596   984   904   840   1211   1128   

B3   679   1192   1256   688   1827   2200   904   1591   1694   
     679   1193   1255   688   1826   2198   904   1591   1723   
     699   1193   1256   673   1826   2196   920   1590   1718   
     679   1193   1255   689   1826   2193   905   1590   1720   

bg   624   845   757   597   977   904   842   1187   1128   
     624   845   757   597   985   904   858   1212   1127   
     624   845   757   597   985   903   842   1212   1127   
     624   845   757   597   985   904   842   1212   1127   

C1   674   899   796   1081   1437   1060   2061   2351   1430   
     674   898   786   1067   1413   1061   2057   2348   1431   
     674   898   787   1078   1437   1062   2054   2347   1431   
     674   898   787   1077   1437   1062   2052   2344   1402   

bg   629   804   758   595   953   905   840   1198   1128   
     623   844   757   596   983   903   857   1211   1127   
     623   844   775   596   983   903   840   1210   1100   
     641   844   756   578   983   902   844   1210   1125   

C2   661   905   801   859   1653   1379   1604   3051   2213   
     661   905   826   886   1654   1380   1604   3047   2214   
     660   888   802   885   1654   1380   1603   3045   2213   
     660   906   803   864   1654   1383   1602   3046   2214   

bg   638   846   759   596   985   906   844   1213   1124   
     623   821   759   596   985   906   840   1213   1131   
     631   845   759   596   985   906   841   1213   1131   
     624   845   771   596   985   905   858   1212   1116   

C3   646   885   811   642   1313   1423   931   2005   2416   
     646   885   811   643   1314   1422   931   2005   2412   
     646   885   811   643   1315   1422   932   2006   2413   
     646   886   812   644   1316   1425   933   2006   2414   

bg   625   847   761   598   957   908   860   1217   1133   
     625   848   761   598   988   909   843   1217   1102   
     638   847   761   598   988   909   843   1217   1134   
     625   847   761   598   988   909   861   1217   1135   


Trial #10-------------------------

     A1    A2    A3    B1    B2    B3    C1    C2    C3    

A1   1772   1921   1055   1058   1442   1037   906   1268   1139   
     1770   1918   1033   1041   1441   1036   907   1268   1164   
     1767   1916   1032   1057   1440   1035   907   1268   1164   
     1765   1913   1031   1057   1439   1036   907   1268   1163   

bg   627   848   760   600   989   908   864   1192   1132   
     626   839   760   599   988   908   845   1218   1133   
     625   847   760   599   988   908   847   1217   1133   
     625   808   760   589   970   908   843   1216   1133   

A2   1321   2527   1801   864   1690   1339   887   1279   1187   
     1312   2542   1787   883   1688   1338   886   1279   1174   
     1312   2541   1784   882   1689   1338   886   1279   1186   
     1331   2538   1781   883   1687   1337   887   1279   1155   

bg   625   846   758   597   986   905   843   1197   1129   
     625   846   758   598   986   906   842   1213   1128   
     625   846   778   597   985   904   859   1213   1128   
     624   846   758   597   985   904   842   1213   1128   

A3   736   1615   2014   643   1326   1370   862   1252   1194   
     723   1600   2034   644   1327   1370   864   1252   1195   
     732   1615   2013   641   1328   1371   862   1253   1196   
     724   1614   2011   644   1328   1370   862   1254   1197   

bg   625   844   761   598   988   908   844   1217   1133   
     626   848   760   599   988   909   844   1217   1133   
     626   848   760   599   988   908   861   1217   1132   
     626   814   769   599   970   909   845   1217   1127   

B1   1083   1285   878   1718   1996   1164   1340   1664   1264   
     1082   1284   878   1694   1994   1163   1339   1662   1264   
     1093   1248   879   1711   1967   1163   1335   1661   1249   
     1080   1282   879   1709   1989   1163   1334   1659   1264   

bg   624   847   760   597   986   908   841   1214   1133   
     643   847   760   597   987   909   842   1216   1104   
     625   847   761   598   987   908   843   1216   1133   
     625   848   761   597   974   909   844   1217   1133   

B2   931   1548   1224   1227   2743   1973   1130   1833   1565   
     929   1545   1200   1235   2730   1964   1128   1829   1562   
     930   1547   1201   1234   2727   1964   1127   1831   1563   
     929   1544   1201   1234   2728   1965   1134   1828   1561   

bg   632   845   759   596   984   906   840   1187   1130   
     623   845   759   596   977   907   840   1212   1130   
     623   845   759   595   984   906   840   1212   1107   
     641   845   759   595   984   906   839   1213   1130   

B3   679   1193   1253   688   1807   2196   914   1591   1721   
     680   1193   1254   689   1829   2195   905   1591   1719   
     680   1194   1254   683   1804   2192   905   1591   1717   
     681   1194   1253   690   1828   2190   924   1590   1717   

bg   637   846   758   597   986   905   843   1200   1108   
     625   817   760   598   958   907   844   1216   1131   
     635   849   783   600   992   910   846   1220   1135   
     630   853   766   603   981   917   850   1226   1146   

C1   689   888   808   1092   1462   1089   2092   2381   1467   
     689   919   808   1070   1462   1089   2072   2377   1466   
     687   917   804   1091   1458   1085   2069   2372   1461   
     684   912   799   1085   1453   1078   2065   2363   1453   

bg   627   848   760   600   990   908   847   1219   1133   
     626   847   759   599   979   906   844   1216   1130   
     638   846   758   598   986   905   843   1214   1129   
     625   846   765   597   985   905   842   1213   1129   

C2   661   907   804   877   1635   1384   1605   3055   2198   
     679   907   804   886   1656   1384   1605   3054   2221   
     660   906   804   884   1654   1382   1616   3044   2217   
     661   906   804   885   1656   1382   1601   3042   2219   

bg   624   846   758   597   985   906   842   1214   1130   
     624   846   758   597   955   905   842   1214   1129   
     624   846   758   597   985   904   842   1213   1128   
     625   807   757   597   985   904   842   1213   1128   

C3   654   870   833   643   1314   1424   931   2007   2420   
     645   885   811   642   1314   1425   931   2006   2421   
     645   853   811   634   1314   1426   951   2006   2422   
     663   885   812   642   1315   1427   930   2006   2395   

bg   623   844   758   595   984   905   840   1183   1129   
     623   844   758   583   984   905   840   1212   1129   
     623   844   782   596   984   905   840   1212   1128   
     624   845   757   596   984   904   841   1212   1128   


Trial #11-------------------------

     A1    A2    A3    B1    B2    B3    C1    C2    C3    

A1   1793   1918   1030   1059   1416   1031   904   1263   1157   
     1773   1916   1034   1034   1437   1031   904   1262   1157   
     1765   1912   1028   1055   1435   1031   904   1262   1157   
     1762   1910   1028   1053   1434   1031   903   1262   1158   

bg   623   839   758   596   984   905   840   1212   1129   
     623   845   758   596   984   905   841   1213   1130   
     623   845   759   596   984   906   840   1212   1130   
     623   845   758   596   985   906   840   1213   1129   

A2   1315   2545   1785   883   1689   1337   886   1278   1183   
     1314   2542   1782   884   1688   1336   887   1277   1183   
     1333   2508   1781   884   1688   1336   887   1278   1165   
     1312   2537   1779   883   1687   1335   887   1277   1182   

bg   624   845   757   596   984   904   842   1212   1127   
     640   806   757   596   983   904   841   1211   1098   
     623   844   757   574   983   904   840   1211   1128   
     622   844   758   595   983   905   839   1211   1128   

A3   721   1613   2013   642   1325   1369   860   1249   1192   
     722   1613   2011   642   1325   1368   860   1249   1192   
     723   1612   2007   633   1325   1367   860   1249   1191   
     723   1597   2004   643   1324   1365   861   1249   1190   

bg   624   844   757   596   984   903   857   1211   1126   
     624   844   756   586   983   903   841   1211   1126   
     623   844   756   596   983   903   841   1211   1101   
     640   844   757   596   983   903   841   1212   1127   

B1   1074   1277   896   1700   1981   1160   1329   1655   1260   
     1074   1277   876   1698   1980   1160   1328   1655   1257   
     1073   1277   876   1698   1979   1160   1327   1654   1261   
     1074   1277   877   1697   1978   1159   1327   1652   1260   

bg   644   844   757   596   984   904   853   1182   1113   
     623   812   756   596   983   903   840   1211   1126   
     624   844   778   596   974   904   848   1210   1125   
     624   843   756   592   983   902   841   1210   1125   

B2   929   1511   1201   1237   2737   1969   1127   1829   1561   
     929   1545   1214   1235   2733   1968   1126   1823   1561   
     929   1544   1201   1235   2732   1967   1126   1828   1562   
     929   1545   1202   1234   2706   1966   1125   1826   1561   

bg   623   844   758   595   983   905   840   1211   1128   
     623   844   758   596   984   904   840   1211   1128   
     623   840   757   575   984   905   859   1211   1127   
     623   845   759   596   984   904   841   1211   1127   

B3   680   1194   1252   689   1828   2194   906   1590   1693   
     697   1194   1253   690   1828   2193   906   1590   1717   
     680   1193   1253   690   1826   2190   906   1590   1695   
     680   1193   1253   689   1828   2191   906   1590   1717   

bg   623   844   758   596   984   906   840   1212   1129   
     623   844   758   582   984   905   840   1211   1129   
     623   844   758   596   976   906   844   1211   1129   
     623   845   758   595   984   905   840   1211   1129   

C1   675   898   809   1078   1434   1059   2056   2344   1428   
     675   898   785   1078   1414   1059   2055   2342   1426   
     675   886   785   1078   1434   1058   2054   2341   1426   
     690   898   785   1077   1410   1058   2052   2340   1394   

bg   623   844   756   596   983   903   840   1187   1126   
     622   842   756   595   982   903   853   1209   1126   
     622   843   756   594   951   904   838   1209   1103   
     622   843   756   590   982   903   838   1209   1126   

C2   659   905   802   885   1655   1384   1605   3058   2221   
     660   905   802   886   1656   1383   1605   3056   2219   
     660   906   802   886   1656   1383   1606   3052   2217   
     661   869   803   887   1656   1382   1606   3050   2215   

bg   623   840   756   596   983   902   841   1180   1110   
     623   843   756   596   983   902   861   1210   1125   
     623   844   778   574   978   903   840   1210   1125   
     623   843   756   595   982   902   839   1209   1114   

C3   644   884   811   640   1313   1428   943   2006   2427   
     644   884   824   640   1293   1428   928   1997   2427   
     644   884   811   641   1314   1427   928   2006   2425   
     644   884   811   641   1314   1427   929   2006   2423   

bg   622   842   754   594   954   900   837   1206   1122   
     635   812   753   579   979   899   837   1205   1088   
     621   841   753   593   950   898   836   1204   1120   
     621   842   755   594   980   899   838   1206   1121   


Trial #12-------------------------

     A1    A2    A3    B1    B2    B3    C1    C2    C3    

A1   1765   1891   1028   1053   1435   1031   924   1262   1158   
     1760   1909   1028   1052   1426   1031   903   1262   1159   
     1755   1906   1029   1050   1432   1032   903   1262   1160   
     1749   1870   1028   1047   1430   1032   902   1262   1160   

bg   623   844   757   595   983   904   839   1211   1128   
     623   844   760   595   983   904   840   1210   1127   
     623   812   757   596   984   904   840   1212   1127   
     637   845   757   594   984   904   860   1212   1127   

A2   1316   2547   1809   884   1690   1337   887   1278   1182   
     1315   2545   1784   884   1689   1336   887   1278   1166   
     1314   2543   1782   862   1688   1336   903   1278   1182   
     1314   2543   1782   883   1689   1336   887   1278   1183   

bg   622   844   756   595   959   904   840   1188   1128   
     622   843   755   594   982   903   839   1210   1126   
     621   842   780   573   981   900   837   1207   1124   
     623   841   753   593   979   899   836   1206   1122   

A3   718   1570   2001   637   1316   1359   854   1238   1179   
     717   1606   1997   637   1305   1354   853   1237   1176   
     717   1604   1994   637   1314   1353   863   1236   1174   
     718   1605   1993   637   1315   1353   853   1236   1175   

bg   619   838   745   591   976   892   834   1170   1113   
     619   838   744   575   976   891   834   1202   1113   
     619   815   765   592   977   891   835   1203   1113   
     619   840   742   592   978   890   835   1204   1112   

B1   1072   1274   858   1701   1981   1144   1328   1652   1212   
     1086   1245   857   1702   1980   1140   1342   1645   1240   
     1074   1275   857   1702   1981   1139   1331   1654   1238   
     1075   1276   856   1703   1980   1137   1331   1655   1236   

bg   621   842   735   587   983   878   840   1211   1097   
     620   841   735   594   981   876   839   1210   1095   
     619   840   735   594   980   875   838   1209   1092   
     618   840   740   592   980   875   837   1208   1092   

B2   923   1540   1181   1232   2732   1938   1122   1823   1527   
     932   1538   1181   1229   2726   1941   1142   1824   1527   
     924   1541   1181   1208   2726   1939   1122   1823   1527   
     935   1540   1181   1231   2723   1938   1123   1824   1507   

bg   621   842   739   595   982   881   855   1211   1096   
     621   842   743   596   983   884   841   1212   1107   
     622   843   742   576   984   887   842   1213   1082   
     622   843   743   596   980   889   842   1212   1112   

B3   677   1188   1262   687   1820   2180   903   1586   1704   
     677   1189   1241   686   1820   2180   902   1585   1706   
     677   1189   1243   686   1819   2181   902   1585   1708   
     688   1164   1255   686   1819   2181   917   1584   1708   

bg   622   815   754   594   982   901   839   1188   1125   
     622   843   755   595   982   901   839   1210   1125   
     641   843   782   595   982   902   842   1210   1125   
     623   844   755   595   983   902   840   1210   1101   

C1   674   898   783   1079   1435   1057   2059   2345   1426   
     674   898   783   1079   1435   1058   2057   2344   1426   
     674   898   784   1078   1435   1058   2055   2342   1426   
     674   897   784   1060   1434   1058   2071   2340   1427   

bg   622   844   757   587   983   904   839   1180   1127   
     631   844   757   595   983   904   839   1210   1110   
     623   844   757   595   984   904   856   1211   1128   
     623   845   757   595   982   906   840   1211   1128   

C2   661   906   802   884   1652   1378   1602   3045   2181   
     661   906   802   885   1652   1378   1602   3030   2209   
     662   907   802   863   1632   1379   1603   3041   2209   
     661   907   803   886   1652   1379   1602   3039   2208   

bg   625   846   759   597   986   906   842   1214   1130   
     639   846   759   597   986   907   842   1215   1131   
     624   813   759   597   986   907   842   1214   1131   
     631   846   759   597   957   908   841   1213   1131   

C3   646   886   841   643   1317   1431   932   2012   2432   
     647   864   813   643   1318   1430   933   2013   2405   
     647   887   813   644   1316   1427   933   2010   2427   
     647   887   813   644   1318   1426   934   2008   2394   

bg   625   847   759   598   987   906   844   1215   1128   
     625   846   763   598   986   906   848   1215   1130   
     625   846   759   597   986   906   842   1214   1130   
     641   813   759   597   985   907   842   1213   1130   

