Trial #17-------------------------

     A1    A2    A3    B1    B2    B3    C1    C2    C3    

A1   310   326   164   186   238   165   143   205   185   
     309   325   164   186   237   165   143   204   185   
     307   324   163   185   236   165   142   204   185   
     306   322   163   184   236   165   142   204   185   

bg   78    107   107   91    144   138   130   194   179   
     78    107   107   91    144   138   129   194   179   
     78    107   107   91    144   138   129   194   179   
     78    107   107   91    144   139   130   194   179   

A2   219   452   318   151   289   208   137   208   190   
     219   452   318   151   289   227   139   208   190   
     219   451   317   151   288   227   139   208   190   
     218   450   317   151   288   227   139   207   190   

bg   77    107   107   91    143   151   130   193   178   
     78    107   107   91    144   138   130   194   179   
     78    107   107   91    144   138   130   194   178   
     78    107   107   91    144   138   130   194   179   

A3   90    264   363   101   214   213   133   202   191   
     98    264   363   101   214   233   134   202   191   
     98    263   363   101   214   233   134   202   191   
     99    263   362   102   214   233   134   203   192   

bg   84    108   154   92    145   153   131   195   180   
     78    108   107   92    144   139   130   195   179   
     78    107   107   91    144   139   130   194   179   
     77    107   106   91    144   138   130   194   178   

B1   164   196   131   318   348   191   230   286   206   
     169   196   132   318   348   192   230   286   206   
     170   196   132   318   348   192   230   286   206   
     170   196   132   317   347   192   230   286   206   

bg   78    107   107   91    144   139   130   194   179   
     78    107   107   91    144   139   130   194   179   
     78    107   107   91    144   139   130   194   179   
     78    107   107   91    144   139   130   194   179   

B2   140   249   198   223   499   355   188   321   266   
     140   249   198   223   498   355   188   320   266   
     140   249   198   222   496   354   188   320   266   
     140   249   198   222   496   353   188   320   266   

bg   78    107   107   91    144   139   129   194   179   
     78    107   107   91    144   138   129   194   179   
     78    107   107   91    144   139   130   194   179   
     78    107   107   91    144   139   130   194   179   

B3   89    178   208   111   315   400   143   272   298   
     89    178   208   111   315   400   142   271   298   
     89    178   208   110   314   399   142   271   297   
     89    178   208   110   314   398   142   271   297   

bg   77    107   106   91    143   138   132   193   178   
     77    107   106   91    143   138   129   193   178   
     77    107   106   91    143   138   129   193   178   
     77    107   106   91    143   138   129   193   178   

C1   88    118   112   191   236   171   349   426   240   
     88    118   113   191   236   170   375   425   240   
     88    118   113   190   236   170   375   425   240   
     88    118   112   190   235   170   374   423   239   

bg   80    107   107   91    144   138   129   258   178   
     78    107   107   91    144   138   129   194   179   
     77    107   107   91    143   138   129   193   178   
     78    107   107   91    144   139   129   194   179   

C2   84    119   116   151   280   235   283   468   398   
     85    119   115   150   279   235   283   567   397   
     84    119   115   150   279   235   282   566   396   
     85    119   115   150   279   235   283   565   396   

bg   77    107   107   91    143   138   129   285   178   
     77    107   107   91    143   138   129   193   178   
     77    107   106   91    143   138   129   193   178   
     77    107   107   91    143   138   129   193   178   

C3   82    115   117   100   211   216   147   317   439   
     82    115   117   101   211   244   148   356   438   
     82    115   117   101   211   244   148   356   438   
     82    115   117   101   211   244   148   356   438   

bg   78    107   107   91    144   157   130   229   178   
     78    107   107   91    144   138   130   194   178   
     78    107   107   92    144   139   130   194   179   
     78    108   107   92    144   139   130   195   180   


Trial #18-------------------------

     A1    A2    A3    B1    B2    B3    C1    C2    C3    

A1   308   324   164   186   237   163   143   204   186   
     307   323   163   185   236   164   142   204   185   
     305   321   162   184   235   164   142   204   184   
     304   320   162   184   235   164   142   204   184   

bg   78    108   116   92    145   140   134   197   180   
     78    108   107   91    144   139   130   194   179   
     77    107   106   91    143   138   129   193   178   
     77    106   106   91    143   137   129   192   177   

A2   219   452   315   151   288   227   136   204   189   
     218   452   317   151   288   227   138   206   189   
     218   450   317   150   287   226   138   206   188   
     218   450   316   150   287   226   138   206   188   

bg   77    106   106   91    143   138   129   194   177   
     77    106   106   90    143   137   128   192   177   
     77    106   106   90    143   137   128   192   177   
     77    106   106   90    143   137   128   192   177   

A3   90    262   362   98    212   232   132   198   189   
     97    262   361   100   212   232   132   200   189   
     97    261   360   100   212   231   132   200   189   
     97    261   360   100   212   231   132   200   189   

bg   82    106   106   92    142   137   128   194   177   
     77    106   106   90    142   137   128   192   177   
     77    106   106   90    142   137   128   192   177   
     77    106   106   90    142   137   128   192   177   

B1   167   195   131   294   346   190   229   272   205   
     169   195   131   317   347   191   229   286   206   
     169   195   131   316   346   191   229   286   206   
     169   195   131   315   345   190   228   283   205   

bg   77    106   106   116   142   137   128   202   177   
     77    106   106   91    143   137   129   193   177   
     77    106   106   91    143   137   129   192   177   
     77    106   106   90    142   137   128   192   177   

B2   139   248   197   207   498   354   187   309   265   
     139   248   197   222   497   354   187   319   265   
     139   248   197   222   496   353   187   319   265   
     139   248   197   222   495   353   187   318   265   

bg   77    106   109   108   143   137   129   199   177   
     77    106   106   91    143   137   129   192   177   
     77    106   106   91    143   137   129   192   177   
     77    106   106   91    143   137   129   192   177   

B3   88    177   207   106   314   399   138   263   297   
     88    177   207   110   314   399   142   270   296   
     88    177   207   110   314   398   142   270   296   
     89    177   207   110   314   398   142   270   296   

bg   77    106   106   95    143   137   131   197   177   
     77    106   106   91    143   137   129   192   177   
     77    106   106   91    142   137   128   192   177   
     77    107   106   91    143   137   128   192   177   

C1   88    117   112   165   234   160   368   410   238   
     88    118   112   189   234   169   372   422   238   
     88    118   112   189   234   169   372   422   238   
     88    118   112   189   234   169   372   421   238   

bg   80    107   106   116   143   144   129   200   177   
     78    107   106   91    143   137   129   192   177   
     78    107   106   91    143   137   129   192   177   
     78    107   106   91    143   137   129   192   177   

C2   84    119   115   151   279   221   283   560   397   
     85    119   115   151   279   235   283   567   397   
     85    119   115   151   279   235   283   566   396   
     85    119   115   151   279   235   283   566   396   

bg   77    107   106   91    142   143   128   193   177   
     77    106   106   91    142   137   128   192   177   
     77    106   106   91    142   137   128   192   177   
     77    106   106   91    142   137   128   192   177   

C3   82    115   115   100   209   242   147   353   436   
     82    115   116   100   209   242   147   354   436   
     82    114   116   100   209   242   147   353   435   
     82    114   116   100   209   242   146   353   435   

bg   77    106   106   91    142   137   128   192   177   
     77    106   106   91    142   137   128   192   177   
     77    106   106   91    142   137   128   192   177   
     77    106   106   90    142   137   128   192   177   


Trial #19-------------------------

     A1    A2    A3    B1    B2    B3    C1    C2    C3    

A1   308   324   163   185   235   163   141   202   183   
     307   323   162   184   235   163   141   202   183   
     305   321   162   184   234   163   141   202   183   
     305   321   162   183   234   163   141   202   183   

bg   77    106   106   90    142   137   131   191   176   
     77    106   106   90    142   137   128   191   176   
     77    106   106   90    142   137   128   191   176   
     77    106   106   90    142   137   128   191   176   

A2   218   450   317   150   287   226   137   205   188   
     218   450   316   150   287   226   138   205   188   
     218   449   316   150   286   226   138   205   188   
     218   449   315   150   286   225   138   205   188   

bg   118   106   106   90    142   137   128   191   176   
     77    106   106   90    142   137   128   191   176   
     77    106   105   90    142   137   128   191   176   
     77    106   105   90    142   136   128   191   176   

A3   91    262   362   100   212   231   132   199   189   
     98    262   361   100   212   231   132   199   189   
     98    262   361   100   212   231   132   199   188   
     98    262   360   100   212   231   132   199   188   

bg   81    106   181   90    142   136   128   191   176   
     77    106   105   90    142   136   128   191   176   
     77    106   105   90    141   136   128   191   176   
     77    106   105   90    141   136   127   190   175   

B1   169   195   129   317   346   189   228   283   203   
     169   195   130   316   346   189   228   282   203   
     169   194   130   316   345   189   227   282   203   
     169   194   130   316   345   189   228   282   203   

bg   77    106   105   90    141   136   127   190   175   
     77    106   105   90    141   136   127   190   175   
     77    106   105   90    141   136   127   190   175   
     77    106   105   90    141   136   127   190   175   

B2   139   248   197   222   498   354   186   318   264   
     139   249   197   222   497   354   186   318   264   
     140   249   198   223   497   354   187   319   265   
     140   249   198   222   496   353   187   319   265   

bg   77    106   105   90    141   181   142   191   176   
     77    105   105   90    141   136   127   190   175   
     77    105   105   90    141   136   127   190   175   
     77    105   105   90    141   136   127   190   175   

B3   88    176   207   109   313   353   138   268   295   
     88    177   207   109   313   398   140   268   295   
     88    177   207   109   313   398   140   268   295   
     88    177   207   109   312   397   140   268   294   

bg   76    105   104   89    140   160   127   189   174   
     76    105   104   89    140   135   127   189   174   
     76    105   105   90    140   135   127   190   175   
     77    106   105   90    141   136   127   190   175   

C1   84    117   111   189   233   167   374   422   237   
     87    116   111   189   233   168   372   421   237   
     87    116   111   189   233   168   372   420   236   
     87    116   111   189   233   167   371   420   236   

bg   78    105   105   89    140   135   127   189   174   
     76    105   105   89    140   135   127   189   174   
     76    105   105   89    141   135   127   189   174   
     76    105   105   89    140   135   127   189   174   

C2   83    117   114   149   276   232   281   563   393   
     84    117   114   149   276   232   280   563   393   
     84    117   113   149   276   232   280   561   392   
     84    117   113   149   276   232   280   560   392   

bg   76    105   104   89    140   135   126   189   174   
     75    104   104   89    140   135   126   188   174   
     75    104   104   89    140   135   126   188   174   
     75    104   104   89    140   135   126   189   174   

C3   81    113   115   99    208   242   146   353   436   
     81    113   115   99    208   242   145   353   435   
     80    113   115   99    208   241   145   352   434   
     80    113   115   99    208   241   145   352   434   

bg   76    106   105   90    142   137   128   191   177   
     76    105   105   90    142   137   128   191   176   
     76    105   104   89    141   135   127   189   175   
     75    105   104   89    140   135   126   189   174   


Trial #20-------------------------

     A1    A2    A3    B1    B2    B3    C1    C2    C3    

A1   305   319   160   182   232   161   136   199   180   
     304   319   160   182   232   161   139   198   180   
     302   318   160   181   231   160   138   198   180   
     301   317   159   181   230   160   138   198   179   

bg   76    106   104   89    140   135   127   189   174   
     76    105   105   89    141   136   127   190   175   
     76    105   104   89    141   135   127   189   175   
     75    104   103   88    139   134   126   188   174   

A2   216   442   294   148   284   223   134   201   184   
     216   448   314   148   284   223   135   201   184   
     216   447   314   148   284   223   135   202   185   
     216   447   314   149   284   223   135   202   185   

bg   109   112   103   88    139   134   126   188   173   
     75    104   103   88    139   134   126   188   173   
     75    104   103   88    139   134   126   188   173   
     75    104   103   88    139   134   126   188   173   

A3   90    228   360   98    209   229   130   195   185   
     96    260   359   98    209   228   130   195   185   
     96    260   359   98    209   228   130   195   185   
     96    259   358   98    209   228   129   195   185   

bg   78    136   103   89    139   172   126   188   173   
     75    104   104   89    140   135   126   188   173   
     75    104   104   89    140   135   126   189   174   
     75    104   104   89    139   134   126   188   173   

B1   166   184   128   314   342   176   225   279   200   
     166   192   128   313   342   186   225   279   200   
     166   192   128   313   341   187   225   279   200   
     166   191   128   312   341   186   224   278   200   

bg   75    112   104   88    201   140   126   188   173   
     76    105   104   89    140   136   127   189   174   
     76    105   105   90    141   136   127   190   176   
     76    104   104   89    140   135   126   189   175   

B2   137   234   194   220   396   346   167   314   261   
     137   245   194   220   492   350   184   314   261   
     137   245   194   219   492   349   183   313   260   
     137   245   194   219   490   349   183   313   260   

bg   75    115   114   88    230   134   134   187   173   
     75    104   103   88    139   134   125   187   173   
     75    104   103   88    139   134   125   187   173   
     75    104   103   88    139   134   125   187   173   

B3   87    165   202   107   260   395   137   265   292   
     87    174   204   108   310   394   138   265   292   
     87    174   204   108   310   394   138   265   291   
     87    174   204   108   310   394   139   265   291   

bg   75    114   104   90    186   134   126   188   173   
     75    104   103   88    139   134   125   187   173   
     75    104   103   88    139   134   125   187   173   
     75    104   103   88    139   134   125   187   173   

C1   83    113   109   178   206   166   371   419   234   
     86    115   109   188   231   166   371   419   234   
     86    115   109   187   231   166   370   418   234   
     86    115   109   188   232   166   370   418   234   

bg   77    106   104   100   163   134   126   188   173   
     75    104   103   88    139   134   126   188   173   
     75    104   103   88    139   134   125   188   173   
     75    103   103   88    139   134   125   187   173   

C2   82    113   112   139   241   231   279   562   392   
     82    116   112   148   275   231   279   562   392   
     82    116   112   148   275   231   279   561   392   
     82    116   112   148   275   231   279   560   391   

bg   75    105   103   97    170   133   125   186   172   
     75    103   103   88    139   134   125   187   172   
     75    103   103   88    139   134   125   187   172   
     75    103   103   88    139   134   125   187   172   

C3   79    110   113   96    190   239   143   349   431   
     79    112   114   98    206   239   144   349   431   
     79    111   113   98    206   239   143   348   430   
     79    111   113   97    205   238   143   348   430   

bg   75    105   103   90    153   133   129   187   172   
     75    103   103   88    138   133   125   187   172   
     75    103   103   88    139   133   125   187   172   
     75    103   103   88    139   134   125   187   172   

