Trial #17-------------------------

     A1    A2    A3    B1    B2    B3    C1    C2    C3    

A1   271   274   115   142   170   102   82    115   103   
     270   273   114   142   170   102   82    115   103   
     269   271   114   141   169   102   82    115   103   
     267   271   114   141   169   102   82    115   103   

bg   109   59    59    49    79    83    70    105   98    
     42    59    59    49    79    77    70    105   97    
     42    59    59    49    79    76    70    105   97    
     42    59    59    49    79    76    70    105   97    

A2   154   403   270   109   223   147   79    119   109   
     183   402   269   109   223   165   79    119   109   
     183   401   268   109   222   165   79    119   109   
     182   400   268   108   221   164   79    118   108   

bg   53    58    59    49    78    87    70    105   97    
     42    59    59    49    79    76    70    105   97    
     42    58    59    49    78    76    69    105   97    
     42    58    59    49    78    76    69    104   97    

A3   61    214   314   59    148   154   73    112   109   
     63    214   314   59    148   170   73    112   110   
     63    214   313   59    148   170   73    112   110   
     63    213   312   59    148   170   73    112   110   

bg   42    58    117   49    78    85    71    104   97    
     42    58    58    49    78    76    69    104   97    
     42    58    58    49    78    76    69    104   97    
     42    58    58    49    78    76    69    104   97    

B1   133   146   83    274   281   128   156   196   123   
     133   146   83    274   280   128   168   195   123   
     133   146   83    273   280   128   168   195   123   
     133   146   83    273   279   128   167   195   123   

bg   42    58    58    49    78    76    69    104   96    
     42    58    59    49    78    76    69    104   97    
     42    58    59    49    78    76    69    105   97    
     42    59    59    49    78    76    69    105   97    

B2   104   200   150   180   331   292   127   231   185   
     104   200   150   180   431   292   127   231   184   
     104   200   149   180   430   291   127   230   184   
     104   200   149   180   429   290   127   230   184   

bg   42    58    58    49    171   76    69    104   96    
     42    58    58    49    78    76    69    104   96    
     42    58    58    49    78    76    69    104   96    
     42    58    58    49    78    76    69    104   96    

B3   50    129   160   68    202   338   82    181   216   
     53    129   160   68    248   337   82    181   215   
     53    129   160   68    248   336   82    181   215   
     53    129   160   68    248   336   82    181   215   

bg   43    58    58    49    121   76    69    104   96    
     42    58    58    49    78    76    69    104   96    
     42    58    58    49    78    76    69    104   97    
     42    58    58    49    78    76    69    104   97    

C1   52    69    63    147   148   107   313   334   157   
     52    69    64    147   169   107   312   333   157   
     52    69    64    147   169   107   312   333   157   
     52    69    64    147   169   107   311   332   157   

bg   42    58    58    49    97    75    141   104   96    
     42    58    58    49    78    76    69    104   96    
     42    58    58    49    78    76    69    104   96    
     42    58    58    49    78    75    69    104   96    

C2   49    70    67    109   186   173   195   480   317   
     49    70    67    109   215   173   224   479   316   
     49    70    67    109   215   173   224   478   316   
     49    70    67    109   215   173   223   477   315   

bg   42    58    58    49    104   101   78    104   96    
     42    58    58    49    78    76    69    104   96    
     42    58    59    49    78    76    69    104   97    
     42    58    59    49    78    76    69    104   97    

C3   46    66    69    58    132   161   87    266   357   
     46    66    69    58    145   181   87    266   355   
     46    66    69    58    145   181   87    265   355   
     46    66    69    58    145   181   87    265   355   

bg   42    58    58    48    88    87    68    103   96    
     42    58    58    48    77    75    68    103   96    
     42    58    58    48    77    75    69    103   96    
     42    58    58    49    77    75    69    103   96    


Trial #18-------------------------

     A1    A2    A3    B1    B2    B3    C1    C2    C3    

A1   204   274   114   142   157   101   81    114   102   
     270   273   114   142   169   102   81    114   102   
     269   272   114   141   169   101   81    114   102   
     267   271   113   140   168   101   81    113   102   

bg   79    58    64    48    87    75    68    103   95    
     41    57    58    48    77    75    68    103   95    
     41    58    58    48    77    75    68    103   95    
     41    58    58    48    77    75    68    103   96    

A2   173   403   269   108   204   164   78    117   107   
     182   402   269   108   221   164   78    117   107   
     182   401   268   108   221   164   78    117   107   
     182   401   268   108   221   164   78    117   107   

bg   42    58    58    48    92    75    68    103   96    
     41    58    58    48    77    75    68    103   95    
     41    57    58    48    77    75    68    103   95    
     41    57    58    48    77    75    68    103   95    

A3   62    195   314   58    131   169   71    110   108   
     62    213   314   58    147   169   72    110   108   
     62    213   313   58    147   169   72    111   108   
     62    213   313   58    147   169   73    111   109   

bg   41    76    58    48    92    75    69    103   95    
     41    57    58    48    77    75    68    103   95    
     41    57    57    48    77    75    68    102   95    
     41    57    57    48    77    75    68    102   95    

B1   133   146   82    275   267   128   168   194   122   
     133   146   82    274   280   127   167   194   122   
     133   146   82    273   280   127   167   193   122   
     133   146   82    273   279   127   167   193   122   

bg   41    57    57    48    87    74    68    102   94    
     41    57    57    48    76    74    68    102   94    
     41    57    57    48    76    74    67    102   94    
     41    57    57    48    76    74    68    102   94    

B2   103   195   134   179   413   291   126   228   182   
     103   199   148   179   430   290   126   228   182   
     103   199   148   179   429   290   126   228   182   
     103   199   148   179   427   289   126   227   182   

bg   56    60    58    48    87    74    67    136   94    
     41    57    57    48    76    74    67    102   94    
     41    57    57    48    76    74    67    101   94    
     41    57    57    48    76    74    67    101   94    

B3   51    124   158   67    241   336   80    157   213   
     52    127   158   67    247   336   80    179   213   
     52    127   158   67    247   335   80    179   213   
     52    128   158   67    247   334   80    179   213   

bg   41    60    57    47    78    141   67    121   94    
     41    56    57    47    76    73    67    101   94    
     41    56    57    47    76    73    67    101   94    
     41    56    57    47    76    74    67    101   94    

C1   51    67    63    146   168   100   244   279   155   
     51    68    63    146   168   106   312   332   155   
     51    68    63    146   168   106   311   332   155   
     51    68    63    146   168   106   310   331   155   

bg   41    58    57    49    76    77    105   150   95    
     41    58    58    48    77    75    68    103   95    
     42    58    58    48    77    75    68    103   96    
     41    57    58    48    77    74    68    102   95    

C2   48    68    66    105   212   167   215   399   313   
     48    69    66    107   211   171   221   473   312   
     48    69    66    107   211   171   221   473   311   
     48    69    66    107   212   171   221   472   311   

bg   41    57    58    51    75    73    67    167   93    
     40    56    57    47    75    73    67    101   93    
     41    56    57    47    75    73    67    101   93    
     41    56    56    47    75    73    67    101   93    

C3   45    64    67    56    143   180   85    236   355   
     45    64    67    57    143   180   85    263   354   
     45    64    67    57    143   180   85    263   354   
     45    64    67    57    143   180   85    263   353   

bg   42    57    56    48    75    73    67    124   93    
     40    56    56    47    75    73    67    100   93    
     40    56    56    47    75    73    67    100   93    
     40    56    56    47    75    73    66    100   93    


Trial #19-------------------------

     A1    A2    A3    B1    B2    B3    C1    C2    C3    

A1   233   256   113   132   168   99    79    109   99    
     269   271   112   140   167   99    79    110   99    
     268   271   112   140   167   99    79    111   99    
     267   269   112   139   167   99    79    111   100   

bg   49    73    56    57    75    73    66    101   93    
     40    56    56    47    75    73    66    100   93    
     40    56    56    47    75    73    66    100   92    
     40    56    56    47    75    73    66    100   92    

A2   180   362   266   97    218   161   75    112   104   
     180   398   266   106   218   161   75    113   104   
     180   398   265   106   218   161   76    113   104   
     180   397   265   106   218   161   76    113   104   

bg   40    93    56    57    75    73    68    101   93    
     40    56    56    47    75    73    66    100   93    
     40    56    56    47    75    73    66    100   93    
     40    56    56    47    75    73    66    100   92    

A3   61    171   233   53    144   167   69    106   105   
     61    211   311   56    144   167   70    107   105   
     61    211   310   56    144   166   70    107   105   
     61    210   309   56    144   166   70    107   105   

bg   40    96    95    50    74    72    66    100   92    
     40    55    56    46    74    72    66    99    92    
     40    55    56    47    74    72    66    99    92    
     40    55    56    46    74    72    66    99    92    

B1   131   131   80    219   277   125   165   188   119   
     131   143   80    271   277   125   165   190   119   
     131   143   80    271   276   125   164   190   119   
     131   144   80    270   276   125   164   190   119   

bg   40    68    56    103   75    84    66    100   92    
     40    55    56    47    74    72    66    99    92    
     40    55    56    47    74    72    66    99    92    
     40    55    56    46    74    72    66    99    92    

B2   87    175   147   141   430   253   124   226   180   
     102   198   147   178   429   288   124   225   180   
     102   198   147   178   427   288   124   225   179   
     102   197   147   177   426   287   124   225   179   

bg   47    78    55    46    74    91    65    98    91    
     40    55    55    46    74    72    65    98    91    
     40    55    55    46    74    72    65    98    91    
     40    55    55    46    74    72    65    98    91    

B3   51    112   156   65    244   325   78    176   210   
     51    126   157   65    244   333   78    176   210   
     51    126   157   66    244   332   78    176   210   
     51    126   156   66    244   332   78    176   210   

bg   39    68    75    46    73    71    68    98    91    
     39    55    55    46    73    71    65    98    91    
     39    55    55    46    73    71    65    98    91    
     39    55    55    46    73    71    65    98    91    

C1   50    64    61    145   166   103   278   330   152   
     50    66    61    145   166   103   310   329   152   
     50    66    61    145   166   104   310   329   152   
     50    66    61    145   166   104   309   329   152   

bg   39    57    55    46    73    71    66    98    91    
     39    55    55    46    73    71    65    98    91    
     39    55    55    46    73    71    65    98    91    
     39    55    55    46    73    71    65    98    91    

C2   47    65    64    106   210   169   220   473   311   
     47    67    64    106   210   169   219   472   310   
     47    67    64    106   210   169   219   471   310   
     47    67    64    106   210   169   219   471   309   

bg   39    57    55    46    73    71    65    98    91    
     40    55    55    46    74    72    65    98    91    
     40    55    55    46    74    72    65    99    91    
     40    55    55    46    74    72    65    99    91    

C3   42    61    66    55    140   177   83    260   351   
     44    63    66    55    140   177   83    260   350   
     43    63    66    55    140   177   83    259   349   
     43    62    66    55    140   177   83    259   349   

bg   40    56    55    46    73    71    64    97    90    
     39    54    55    46    73    71    64    97    90    
     39    54    55    46    73    71    64    97    90    
     39    54    55    45    73    71    64    97    90    


Trial #20-------------------------

     A1    A2    A3    B1    B2    B3    C1    C2    C3    

A1   261   224   111   139   165   97    77    107   96    
     267   269   110   138   164   97    77    107   96    
     265   268   110   137   164   97    77    107   96    
     264   266   110   137   163   96    76    107   96    

bg   39    99    56    45    73    71    67    97    90    
     39    54    54    45    73    71    64    97    90    
     39    54    54    45    73    71    64    97    90    
     39    54    54    45    73    71    64    97    90    

A2   179   315   265   105   217   159   72    110   101   
     180   398   265   105   217   159   74    110   101   
     180   397   264   105   216   159   74    111   101   
     179   396   264   105   216   159   74    111   101   

bg   39    136   54    45    73    89    65    97    90    
     39    54    54    45    72    70    64    96    90    
     39    54    54    45    72    70    64    96    89    
     39    54    54    45    72    70    64    96    89    

A3   59    147   310   55    142   138   68    104   102   
     59    209   310   55    142   164   68    104   102   
     59    209   308   55    142   164   68    104   102   
     59    209   308   55    142   164   68    104   102   

bg   39    116   54    45    72    89    64    96    89    
     39    54    54    45    72    70    64    96    89    
     39    54    54    45    72    70    64    96    89    
     39    54    54    45    72    70    64    96    89    

B1   130   118   79    271   276   123   163   188   116   
     130   142   79    271   275   123   163   187   116   
     130   142   79    270   275   123   163   187   116   
     130   142   79    270   274   123   162   187   116   

bg   58    78    54    45    72    70    64    96    89    
     39    54    54    45    72    70    64    96    89    
     39    54    54    45    72    70    64    96    89    
     39    54    54    45    72    70    64    96    89    

B2   94    154   140   177   428   287   122   223   177   
     101   196   145   177   427   287   122   223   177   
     101   196   145   176   425   286   122   222   177   
     101   196   145   176   425   285   122   222   177   

bg   39    54    54    45    72    70    64    96    89    
     39    54    54    45    72    70    64    96    89    
     39    54    54    45    72    70    64    96    89    
     39    54    54    45    72    70    64    96    89    

B3   50    124   155   64    243   332   74    174   208   
     50    124   155   64    243   332   77    174   208   
     50    125   155   65    243   331   77    173   208   
     50    125   155   65    242   330   77    173   208   

bg   39    54    54    45    72    70    65    96    89    
     39    54    54    45    72    70    64    96    89    
     39    54    54    45    72    70    64    96    89    
     39    54    54    45    72    70    64    96    89    

C1   49    64    60    143   163   102   308   326   150   
     49    64    60    143   163   102   307   326   150   
     49    64    60    143   163   102   306   325   149   
     49    64    60    143   163   102   306   325   149   

bg   39    54    54    45    72    70    64    96    89    
     39    54    54    45    72    70    63    96    89    
     39    54    54    45    72    70    63    96    89    
     39    54    54    45    72    70    63    96    89    

C2   46    66    63    105   209   168   219   472   310   
     46    66    63    105   209   168   219   472   309   
     46    66    63    105   209   168   218   470   309   
     46    66    63    105   209   168   218   470   308   

bg   40    53    54    45    72    70    63    95    89    
     38    53    54    45    72    70    63    95    89    
     38    53    54    45    72    70    63    96    89    
     38    54    54    45    72    70    63    96    89    

C3   42    62    65    54    139   146   82    258   350   
     43    62    65    54    139   176   82    258   349   
     43    62    65    54    139   176   82    258   349   
     43    62    65    54    139   176   82    258   348   

bg   39    54    54    45    72    91    63    96    89    
     39    54    54    45    72    70    64    96    89    
     39    54    54    45    72    70    63    96    89    
     39    53    54    45    72    70    63    96    89    

