    A1  A2  A3  B1  B2  B3  C1  C2   C3   
bg  13  14  7   8   13  9   10  12   9  
    13  14  7   8   12  9   10  12   9  
    13  12  7   8   13  9   10  12   9  
    13  14  7   8   13  9   10  12   9  
    
A1  81  75  22  36  39  15  14  17  11  
    80  75  22  36  39  15  14  15  11  
    80  75  22  36  37  15  14  15  11  
    80  75  22  36  39  15  14  15  11  
    
A2  50  123 73  23  51  32  13  15  12  
    50  123 73  23  50  32  13  16  12  
    50  123 73  23  51  32  13  15  12  
    50  123 74  23  51  32  13  15  12  
    
A3  19  67  89  11  34  39  12  15  13  
    18  67  90  11  34  39  11  15  13  
    19  67  89  11  34  39  11  15  13  
    19  67  89  11  34  39  11  15  13  
    
B1  41  39  13  82  76  24  44  40  17  
    41  39  13  82  76  24  43  40  17  
    41  39  13  82  76  24  43  40  16  
    41  39  13  82  76  24  43  42  17  
    
B2  31  58  34  51  128 77  31  55  36  
    31  58  34  51  128 77  31  55  36  
    31  58  34  51  128 77  31  55  36  
    31  58  35  51  128 77  31  55  36  
    
B3  15  33  34  13  62  88  14  38  45  
    15  31  34  13  62  88  14  38  45  
    15  33  34  13  62  88  14  38  45  
    16  33  35  13  62  88  14  38  45  
    
C1  16  17  9   41  45  20  92  89  31  
    16  17  9   41  45  20  92  86  31  
    16  17  9   41  45  20  92  88  31  
    16  17  9   41  45  20  92  87  31  
    
C2  15  17  9   24  50  34  54  117 71  
    16  17  9   23  50  34  54  118 71  
    15  17  10  24  49  34  54  117 71  
    15  17  9   24  50  34  54  117 71  
    
C3  14  16  10  11  33  41  17  64  86  
    15  16  10  11  33  41  17  64  85  
    14  16  10  11  34  41  17  64  86  
    14  16  10  11  34  41  17  64  86  
    
