    A1   A2   A3   B1   B2   B3   C1   C2   C3   
bg  13  14  7  8  13  9  10  12  9  
    14  14  7  8  13  9  10  12  8  
    13  14  7  8  13  9  10  12  9  
    14  14  7  8  13  9  10  12  9  
    
A1  79  75  22  36  38  15  14  15  11  
    79  75  22  36  38  15  14  16  11  
    79  74  22  36  38  15  15  15  11  
    79  75  22  36  38  15  14  15  11  
    
A2  50  122  73  22  51  32  13  15  12  
    50  123  73  23  50  32  13  15  12  
    50  123  73  23  51  32  13  17  12  
    50  122  73  22  50  32  13  15  12  
    
A3  19  67  89  11  34  39  11  16  13  
    19  67  89  11  34  39  12  14  13  
    18  67  89  11  34  39  11  14  13  
    18  65  89  11  34  39  12  14  13  
    
B1  41  39  13  82  76  24  43  40  17  
    41  37  13  82  76  24  43  40  17  
    42  39  13  82  76  24  43  41  17  
    41  39  13  82  76  24  43  40  16  
    
B2  30  58  34  51  127  77  31  57  36  
    30  58  34  50  128  77  31  54  36  
    30  57  34  51  127  77  31  54  36  
    30  57  34  50  128  76  31  54  36  
    
B3  15  33  34  13  62  87  14  37  44  
    15  33  34  13  62  87  14  37  45  
    15  31  35  13  62  87  14  38  45  
    15  33  34  13  62  88  14  38  45  
    
C1  16  17  9  41  45  20  92  86  31  
    16  17  9  41  45  20  92  87  31  
    16  17  9  41  45  20  92  87  31  
    16  16  9  41  44  20  93  88  31  
    
C2  15  17  9  23  51  34  54  118  72  
    15  16  10  24  51  35  55  121  72  
    15  17  10  24  50  35  55  119  72  
    15  17  10  24  51  35  55  119  73  
    
C3  14  16  10  10  33  41  18  64  85  
    14  16  10  11  33  41  17  64  86  
    14  16  10  11  33  41  17  64  86  
    14  16  10  11  34  41  17  64  86  
    
