    A1   A2   A3   B1   B2   B3   C1   C2   C3   
bg  14  14  7  8  13  9  10  12  9  
    13  14  7  8  13  9  11  14  8  
    13  14  7  7  12  9  10  12  9  
    13  14  7  8  13  9  10  12  9  
    
A1  80  75  22  36  38  15  14  15  11  
    80  74  22  36  38  15  14  17  11  
    80  75  22  36  38  15  14  15  11  
    80  75  22  36  38  15  14  15  11  
    
A2  50  123  73  23  51  32  13  17  12  
    50  123  73  23  51  32  13  15  11  
    50  122  73  22  51  32  13  15  12  
    50  123  73  23  51  32  13  15  12  
    
A3  18  67  89  11  34  39  11  15  13  
    19  67  90  11  34  39  11  15  13  
    19  67  89  11  34  39  11  14  13  
    19  66  89  11  34  39  11  14  13  
    
B1  41  39  13  82  76  24  43  40  17  
    41  39  14  82  76  24  43  40  17  
    41  39  13  82  75  24  43  40  17  
    41  39  13  82  76  24  43  40  17  
    
B2  31  58  34  51  128  77  31  54  36  
    30  58  34  51  128  77  31  54  36  
    30  57  34  50  128  77  31  54  36  
    31  57  34  50  128  76  31  54  36  
    
B3  15  33  34  13  62  87  14  37  45  
    15  33  34  13  62  87  15  37  45  
    15  33  34  13  62  87  14  37  44  
    15  33  34  13  62  87  14  37  45  
    
C1  16  17  9  41  45  20  92  86  31  
    16  17  9  41  44  20  92  86  31  
    16  17  9  41  45  20  92  86  31  
    16  17  9  41  45  20  92  86  31  
    
C2  15  17  9  24  50  34  54  119  72  
    16  17  9  24  50  34  55  118  72  
    15  17  10  24  51  34  54  118  73  
    15  17  10  24  51  35  55  119  73  
    
C3  14  16  10  11  33  40  17  64  86  
    14  16  10  11  33  40  17  65  86  
    14  15  11  11  33  40  17  64  86  
    14  16  10  11  33  41  17  65  86  
    
