    A1   A2   A3   B1   B2   B3   C1   C2   C3   
bg  13  14  8  8  13  9  10  12  9  
    13  13  7  8  13  9  11  12  9  
    13  14  7  8  13  9  10  12  8  
    14  13  8  8  13  9  10  12  9  
    
A1  80  75  22  36  38  15  14  15  11  
    80  75  22  36  38  15  15  15  11  
    80  75  22  36  38  15  14  15  11  
    80  75  22  35  38  15  14  15  11  
    
A2  50  123  73  22  51  32  13  15  12  
    50  121  73  23  51  32  13  15  12  
    50  123  73  23  51  32  13  15  12  
    50  123  73  23  51  32  13  15  12  
    
A3  18  65  89  11  34  39  11  14  13  
    19  67  89  11  34  39  12  14  13  
    19  67  89  11  34  39  11  14  13  
    19  67  89  11  33  39  12  14  13  
    
B1  41  39  13  82  76  24  43  40  17  
    41  38  13  82  76  24  43  40  17  
    41  39  13  82  76  24  43  40  16  
    41  39  13  82  76  24  43  41  17  
    
B2  31  58  34  50  128  77  31  55  36  
    31  58  34  51  128  77  31  54  36  
    30  58  35  51  128  77  31  54  35  
    30  58  34  51  128  77  31  54  36  
    
B3  15  33  34  13  62  88  14  37  45  
    15  32  34  13  62  87  14  37  45  
    16  33  35  13  62  88  14  37  45  
    15  31  34  13  62  87  14  39  45  
    
C1  16  17  9  41  45  20  92  86  31  
    17  17  9  40  45  20  92  86  31  
    16  17  9  41  45  20  92  86  31  
    16  17  9  41  45  20  93  87  31  
    
C2  15  17  9  24  51  34  54  118  72  
    15  17  10  23  51  34  54  118  72  
    15  17  10  24  51  35  55  120  72  
    15  17  10  24  51  35  55  119  72  
    
C3  14  16  10  11  33  40  17  64  86  
    14  16  10  11  33  40  17  66  85  
    14  16  10  11  33  40  17  64  86  
    14  16  10  11  33  41  17  64  86  
    
