Trial #5-------------------------

     A1    A2    A3    B1    B2    B3    C1    C2    C3    

A1   43    43    19    23    27    17    14    19    17    
     43    43    19    23    27    17    14    19    17    
     43    43    19    23    27    17    14    19    17    
     43    43    19    23    27    17    13    19    17    

bg   7     10    10    8     13    13    12    17    16    
     7     10    10    8     13    13    12    17    16    
     7     10    10    8     13    13    12    17    16    
     7     10    10    8     13    13    12    17    16    

A2   29    63    43    17    35    27    13    20    18    
     29    63    43    17    35    27    13    20    18    
     29    63    43    17    35    27    13    20    18    
     29    63    43    17    35    26    13    20    18    

bg   7     10    10    8     13    13    12    17    16    
     7     10    10    8     13    13    12    17    16    
     7     10    10    8     13    13    12    17    16    
     7     10    10    8     13    13    12    17    16    

A3   10    34    50    10    24    27    12    19    18    
     10    34    49    10    24    27    12    19    18    
     10    34    50    10    24    27    12    19    18    
     10    34    49    10    24    27    12    19    18    

bg   7     10    10    8     13    13    11    17    16    
     7     10    10    8     13    13    12    17    16    
     7     10    10    8     13    13    12    17    16    
     7     10    10    8     13    13    12    17    16    

B1   21    23    14    43    45    21    27    32    20    
     21    23    14    43    45    21    27    32    20    
     21    23    14    43    44    21    27    32    20    
     21    23    14    43    44    21    27    32    20    

bg   7     10    10    8     13    13    12    17    16    
     7     10    10    8     13    13    12    17    16    
     7     10    10    8     13    13    11    17    16    
     7     10    10    8     13    13    11    17    16    

B2   17    32    24    29    68    46    21    37    30    
     17    32    24    29    68    46    21    37    30    
     17    32    24    29    68    46    21    37    30    
     17    32    24    29    68    46    21    37    30    

bg   7     10    10    8     13    13    11    17    16    
     7     10    10    8     13    13    11    17    16    
     7     10    10    8     13    13    11    17    16    
     7     10    10    8     13    13    11    17    16    

B3   9     21    26    11    40    54    14    29    35    
     9     21    26    11    40    54    14    29    35    
     9     21    26    11    40    53    13    29    35    
     9     21    26    11    40    53    13    29    34    

bg   7     10    10    8     13    13    11    17    16    
     7     10    10    8     13    13    11    17    16    
     7     10    10    8     13    13    12    17    16    
     7     10    10    8     13    13    12    17    16    

C1   8     11    11    24    27    18    50    53    25    
     8     11    11    23    27    18    50    53    25    
     8     11    11    23    27    18    50    53    25    
     8     11    11    23    27    18    49    53    25    

bg   7     10    10    8     13    13    11    17    16    
     7     10    10    8     13    13    11    17    16    
     7     10    10    8     13    13    11    17    16    
     7     10    10    8     13    13    11    17    16    

C2   8     12    11    17    34    28    36    76    50    
     8     12    11    17    34    28    36    76    50    
     8     12    11    18    34    28    36    76    50    
     8     12    11    17    34    28    36    76    50    

bg   7     10    10    8     13    13    11    17    16    
     7     10    10    8     13    13    11    17    16    
     7     10    10    8     13    13    11    17    16    
     7     10    10    8     13    13    11    17    16    

C3   8     11    11    10    23    29    14    43    56    
     8     11    12    10    23    29    14    43    56    
     8     11    12    10    23    29    14    43    56    
     8     11    12    10    23    29    14    43    56    

bg   7     10    10    8     13    13    12    17    16    
     7     10    10    8     13    13    11    17    16    
     7     10    10    8     13    13    11    17    16    
     7     10    10    8     13    13    11    17    16    


Trial #6-------------------------

     A1    A2    A3    B1    B2    B3    C1    C2    C3    

A1   43    43    19    23    27    17    13    19    17    
     43    43    18    23    27    17    13    19    17    
     43    43    18    23    27    17    13    19    17    
     42    43    18    23    27    17    13    19    17    

bg   7     10    10    8     13    13    11    17    16    
     7     10    10    8     13    13    11    17    16    
     7     10    10    8     13    13    11    17    16    
     7     10    10    8     13    13    11    17    16    

A2   29    63    43    17    35    26    13    19    18    
     29    63    43    17    35    26    13    19    18    
     29    63    43    17    35    26    13    19    18    
     29    63    43    17    35    26    13    19    18    

bg   7     10    10    8     13    13    11    17    16    
     7     10    10    8     13    13    11    17    16    
     7     10    10    8     13    12    11    17    16    
     7     10    10    8     13    12    11    17    16    

A3   10    34    50    10    24    27    12    18    18    
     10    34    50    10    24    27    12    18    18    
     10    34    50    10    24    27    12    19    18    
     10    34    50    10    24    27    12    19    18    

bg   7     10    10    8     13    13    11    17    16    
     7     10    10    8     13    13    11    17    16    
     7     10    10    8     13    13    11    17    16    
     7     10    10    8     13    13    11    17    16    

B1   21    23    13    43    44    21    27    31    20    
     21    23    13    43    44    21    27    31    20    
     21    23    13    43    44    21    27    31    20    
     21    23    13    43    44    21    27    31    20    

bg   7     10    10    8     13    12    11    17    16    
     7     10    10    8     13    12    11    17    16    
     7     10    10    8     13    12    11    17    16    
     7     10    10    8     13    12    11    17    16    

B2   16    32    24    29    68    46    20    37    29    
     17    32    24    29    68    46    20    37    29    
     17    32    24    29    68    46    20    37    29    
     16    32    24    28    68    46    20    37    29    

bg   7     10    10    8     13    12    11    17    16    
     7     10    10    8     13    12    11    17    16    
     7     10    10    8     13    12    11    17    16    
     7     10    10    8     13    12    11    17    16    

B3   9     21    26    11    40    54    13    29    34    
     9     21    26    11    40    54    13    29    34    
     9     21    26    11    40    54    14    29    34    
     9     21    26    11    40    53    14    29    34    

bg   7     10    10    8     13    13    12    17    16    
     7     10    10    8     13    13    12    17    16    
     7     10    10    8     13    13    12    17    16    
     7     10    10    8     13    13    12    17    16    

C1   9     11    11    24    27    18    50    53    25    
     9     11    11    24    27    17    50    53    25    
     9     11    11    24    27    17    50    53    25    
     9     11    11    24    27    17    50    53    25    

bg   7     10    10    8     13    12    11    17    16    
     7     10    10    8     13    12    11    17    16    
     7     10    10    8     13    12    11    17    16    
     7     10    10    8     13    12    11    17    16    

C2   8     12    11    18    34    28    36    76    50    
     8     12    11    18    34    28    36    76    50    
     8     12    11    18    34    28    36    76    50    
     8     12    11    18    34    28    36    76    50    

bg   7     10    10    8     13    12    11    17    16    
     7     10    10    8     13    12    11    17    16    
     7     10    10    8     13    12    11    17    16    
     7     9     10    8     13    12    11    17    16    

C3   8     11    11    10    23    29    14    42    56    
     8     11    11    10    23    29    14    42    56    
     7     11    11    9     23    29    14    42    56    
     7     11    11    9     23    29    14    42    56    

bg   7     9     10    8     13    12    11    17    16    
     7     9     10    8     13    12    11    17    16    
     7     9     10    8     13    12    11    17    16    
     7     9     10    8     13    12    11    17    16    


Trial #7-------------------------

     A1    A2    A3    B1    B2    B3    C1    C2    C3    

A1   43    43    18    23    27    16    13    18    17    
     43    43    18    23    27    16    13    18    17    
     43    43    18    22    27    16    13    18    17    
     42    43    18    22    27    16    13    18    17    

bg   7     9     10    8     13    12    11    17    16    
     7     9     10    8     13    12    11    17    16    
     7     10    10    8     13    12    11    17    16    
     7     10    10    8     13    12    11    17    16    

A2   29    63    43    17    35    26    13    19    17    
     29    63    43    17    35    26    13    19    17    
     29    63    43    17    35    26    13    19    17    
     29    63    42    17    35    26    13    19    17    

bg   7     10    10    8     13    12    11    17    16    
     7     10    10    8     13    12    11    17    16    
     7     9     10    8     13    12    11    17    16    
     7     9     10    8     13    12    11    17    16    

A3   10    34    50    9     23    27    12    18    18    
     10    34    49    9     23    27    12    18    18    
     10    34    49    9     23    27    12    18    18    
     10    34    49    9     23    27    12    18    18    

bg   7     9     10    8     13    12    11    17    15    
     7     9     10    8     12    12    11    17    15    
     7     9     9     8     12    12    11    17    15    
     7     9     10    8     12    12    11    17    15    

B1   21    23    13    43    44    20    27    31    20    
     21    23    13    43    44    20    27    31    20    
     21    23    13    43    44    20    27    31    20    
     21    23    13    43    44    20    27    31    20    

bg   7     9     10    8     12    12    11    17    15    
     7     9     10    8     13    12    11    17    15    
     7     9     10    8     13    12    11    17    16    
     7     9     10    8     13    12    11    17    16    

B2   16    32    24    28    68    46    20    37    29    
     16    32    24    28    68    46    20    37    29    
     16    32    24    28    68    46    20    37    29    
     16    32    24    28    68    46    20    36    29    

bg   7     9     9     8     12    12    11    17    15    
     7     9     9     8     12    12    11    17    15    
     7     9     9     8     12    12    11    17    15    
     7     9     9     8     12    12    11    17    15    

B3   9     21    25    11    39    53    13    29    34    
     9     21    25    11    39    53    13    29    34    
     9     21    25    11    39    53    13    29    34    
     9     21    25    11    39    53    13    29    34    

bg   7     9     9     8     12    12    11    17    15    
     7     9     9     8     12    12    11    17    15    
     7     9     9     8     12    12    11    17    15    
     7     9     9     8     12    12    11    17    15    

C1   8     11    10    23    27    17    49    53    25    
     8     11    10    23    27    17    49    53    25    
     8     11    10    23    27    17    49    53    25    
     8     11    10    23    27    17    49    53    25    

bg   7     9     9     8     12    12    11    17    15    
     7     9     9     8     12    12    11    17    15    
     7     9     9     8     12    12    11    17    15    
     7     9     9     8     12    12    11    17    15    

C2   8     11    11    17    34    27    35    75    50    
     8     11    11    17    34    27    35    75    50    
     8     11    11    17    34    27    35    75    49    
     8     11    11    17    34    27    35    75    49    

bg   7     9     9     8     12    12    11    17    15    
     7     9     9     8     12    12    11    17    15    
     7     9     9     8     12    12    11    17    15    
     7     9     9     8     12    12    11    17    15    

C3   8     11    11    10    23    29    14    42    56    
     8     11    11    10    23    29    14    42    56    
     8     11    11    10    23    29    14    42    56    
     8     11    11    10    23    29    14    42    56    

bg   7     9     9     8     12    12    11    17    15    
     7     9     9     8     12    12    11    17    15    
     7     9     9     8     12    12    11    17    15    
     7     9     9     8     12    12    11    17    15    


Trial #8-------------------------

     A1    A2    A3    B1    B2    B3    C1    C2    C3    

A1   43    43    18    23    27    16    13    18    16    
     43    43    18    22    27    16    13    18    16    
     42    43    18    22    27    16    13    18    16    
     42    43    18    22    27    16    13    18    16    

bg   7     9     9     8     12    12    11    17    15    
     7     9     9     8     12    12    11    17    15    
     7     9     9     8     12    12    11    17    15    
     7     9     9     8     12    12    11    17    15    

A2   28    63    42    17    35    26    12    19    17    
     28    63    42    17    35    26    12    19    17    
     28    63    42    17    35    26    12    19    17    
     28    63    42    17    35    26    12    19    17    

bg   7     9     9     8     12    12    11    17    15    
     7     9     9     8     12    12    11    17    15    
     7     9     9     8     12    12    11    17    15    
     7     9     9     8     12    12    11    17    15    

A3   10    34    49    9     23    27    12    18    17    
     10    34    49    9     23    27    12    18    17    
     10    34    49    9     23    27    12    18    17    
     10    34    49    9     23    27    12    18    17    

bg   7     9     9     8     12    12    11    17    15    
     7     9     9     8     12    12    11    17    15    
     7     9     9     8     12    12    11    17    15    
     7     9     9     8     12    12    11    17    15    

B1   21    23    13    43    44    20    27    31    20    
     21    23    13    43    44    20    27    31    20    
     21    23    13    43    44    20    26    31    20    
     21    23    13    43    44    20    26    31    19    

bg   7     9     9     8     12    12    11    17    15    
     7     9     9     8     12    12    11    17    15    
     7     9     9     8     12    12    11    17    15    
     7     9     9     8     12    12    11    17    15    

B2   16    32    24    29    68    46    20    37    29    
     16    32    24    29    68    46    20    37    29    
     16    32    24    28    68    46    20    37    29    
     16    32    24    28    68    46    20    36    29    

bg   7     9     9     8     12    12    11    17    15    
     7     9     9     8     12    12    11    17    15    
     7     9     9     8     12    12    11    17    15    
     7     9     9     8     12    12    11    17    15    

B3   8     20    25    11    39    53    13    29    34    
     8     20    25    11    39    53    13    29    34    
     8     20    25    11    39    53    13    29    34    
     8     20    25    11    39    53    13    29    34    

bg   7     9     9     8     12    12    11    17    15    
     7     9     9     8     12    12    11    16    15    
     7     9     9     8     12    12    11    17    15    
     7     9     9     8     12    12    11    17    15    

C1   8     11    10    23    27    17    49    53    25    
     8     11    10    23    27    17    49    53    25    
     8     11    10    23    27    17    49    53    25    
     8     11    10    23    27    17    49    53    25    

bg   7     9     9     8     12    12    11    17    15    
     7     9     9     8     12    12    11    17    15    
     7     9     9     8     12    12    11    17    15    
     7     9     9     8     12    12    11    17    15    

C2   8     11    11    17    34    27    35    75    49    
     8     11    11    17    34    27    35    75    49    
     8     11    11    17    34    27    35    75    49    
     8     11    11    17    34    27    35    75    49    

bg   7     9     9     8     12    12    11    16    15    
     7     9     9     8     12    12    11    16    15    
     7     9     9     8     12    12    11    16    15    
     7     9     9     8     12    12    11    17    15    

C3   7     11    11    9     23    29    14    42    56    
     7     11    11    9     23    29    14    42    56    
     7     11    11    9     23    29    14    42    56    
     7     11    11    9     23    29    14    42    56    

bg   7     9     9     8     12    12    11    17    15    
     7     9     9     8     12    12    11    17    15    
     7     9     9     8     12    12    11    17    15    
     7     9     9     8     12    12    11    17    15    

