Trial #5-------------------------

     A1    A2    A3    B1    B2    B3    C1    C2    C3    

A1   48    51    26    29    37    26    22    32    29    
     48    51    26    29    37    26    22    32    29    
     48    50    26    29    37    26    22    32    29    
     48    50    26    29    37    26    22    32    29    

bg   12    17    17    14    22    22    20    30    28    
     12    17    17    14    22    22    20    30    28    
     12    17    17    14    22    22    20    30    28    
     12    17    17    14    22    22    20    30    28    

A2   34    70    50    24    45    36    22    32    30    
     34    70    50    24    45    35    22    32    30    
     34    70    50    24    45    35    22    32    30    
     34    70    50    24    45    35    22    32    30    

bg   12    17    17    14    22    22    20    30    28    
     12    17    17    14    22    22    20    30    28    
     12    17    17    14    22    22    20    30    28    
     12    17    17    14    22    21    20    30    28    

A3   15    41    57    16    33    36    21    31    30    
     15    41    57    16    33    36    21    31    30    
     15    41    57    16    33    36    21    31    30    
     15    41    56    16    33    36    21    31    30    

bg   12    17    17    14    22    21    20    30    28    
     12    17    17    14    22    21    20    30    28    
     12    17    17    14    22    22    20    30    28    
     12    17    17    14    22    22    20    30    28    

B1   26    31    21    49    54    30    36    44    32    
     26    30    21    49    54    30    36    44    32    
     26    30    21    49    54    30    36    44    32    
     26    30    21    49    54    30    36    44    32    

bg   12    17    17    14    22    21    20    30    28    
     12    17    17    14    22    22    20    30    28    
     12    17    17    14    22    21    20    30    28    
     12    17    17    14    22    21    20    30    28    

B2   22    39    31    35    78    55    29    50    41    
     22    39    31    35    77    55    29    50    41    
     22    39    31    35    77    55    29    50    41    
     22    39    31    35    77    55    29    49    41    

bg   12    16    16    14    22    21    20    30    27    
     12    16    16    14    22    21    20    29    27    
     12    16    16    14    22    21    20    29    27    
     12    16    16    14    22    21    20    29    27    

B3   14    27    32    17    48    62    22    41    46    
     14    27    32    17    48    62    22    41    45    
     13    27    32    17    48    62    22    41    45    
     13    27    32    17    48    62    22    41    45    

bg   12    16    16    14    22    21    20    29    27    
     12    16    16    14    22    21    20    29    27    
     12    16    16    14    22    21    20    29    27    
     12    16    16    14    22    21    19    29    27    

C1   13    18    17    29    36    26    58    65    36    
     13    18    17    29    36    26    58    65    36    
     13    18    17    29    36    26    58    65    36    
     13    18    17    29    36    26    58    65    36    

bg   12    16    16    14    21    21    19    29    27    
     12    16    16    14    21    21    19    29    27    
     12    16    16    14    21    21    19    29    27    
     12    16    16    14    21    21    19    29    27    

C2   13    18    17    23    43    36    43    87    61    
     13    18    17    23    43    36    43    87    61    
     13    18    17    23    43    36    43    87    61    
     13    18    17    23    43    36    43    87    61    

bg   12    16    16    14    21    21    19    29    26    
     12    16    16    14    21    21    19    29    26    
     12    16    16    14    21    21    19    29    26    
     12    16    16    14    21    21    19    29    26    

C3   12    17    18    15    32    37    22    54    67    
     12    17    18    15    32    37    22    54    67    
     12    17    18    15    32    37    22    54    67    
     12    17    18    15    32    37    22    54    67    

bg   11    16    16    14    21    21    19    29    26    
     11    16    16    14    21    21    19    29    26    
     11    16    16    14    21    20    19    29    26    
     11    16    16    14    21    20    19    29    26    


Trial #6-------------------------

     A1    A2    A3    B1    B2    B3    C1    C2    C3    

A1   47    50    25    28    36    25    21    30    27    
     47    50    25    28    36    25    21    30    27    
     47    49    25    28    35    24    21    30    27    
     47    49    25    28    35    24    21    30    27    

bg   11    16    16    13    21    20    19    28    26    
     11    16    16    13    21    20    19    28    26    
     11    16    16    13    21    20    19    28    26    
     11    16    16    13    21    20    19    28    26    

A2   33    70    49    23    44    34    20    30    28    
     33    70    49    23    44    34    20    31    28    
     33    70    49    23    44    34    20    31    28    
     33    70    49    23    44    34    21    31    28    

bg   11    16    16    13    21    20    19    28    26    
     11    16    16    14    21    20    19    29    26    
     11    16    16    14    21    21    19    29    26    
     12    16    16    14    21    21    19    29    26    

A3   15    40    56    15    32    35    20    30    29    
     15    40    56    15    32    36    20    30    29    
     15    41    56    15    32    36    20    30    29    
     15    40    56    15    32    36    20    30    29    

bg   12    16    16    14    22    21    20    29    27    
     12    16    16    14    22    21    20    29    27    
     12    16    16    14    22    21    20    29    27    
     12    16    16    14    22    21    20    30    27    

B1   26    30    20    49    54    30    36    44    32    
     26    30    20    49    54    30    36    44    32    
     26    30    20    49    54    30    36    44    32    
     26    30    20    49    54    30    36    44    32    

bg   12    17    17    14    22    21    20    30    28    
     12    17    17    14    22    21    20    30    28    
     12    17    17    14    22    22    20    30    28    
     12    17    17    14    22    22    20    30    28    

B2   22    39    31    35    78    55    29    50    41    
     22    39    31    35    78    55    29    50    41    
     22    39    31    35    78    55    29    50    41    
     22    39    31    35    78    55    29    50    41    

bg   12    17    17    14    22    22    20    30    28    
     12    17    17    14    22    22    20    30    28    
     12    17    17    14    22    22    20    30    28    
     12    17    17    14    22    22    20    30    28    

B3   14    28    32    17    49    62    22    42    46    
     14    28    32    17    49    62    22    42    46    
     14    28    32    17    49    62    22    42    46    
     14    28    32    17    49    62    22    42    46    

bg   12    17    17    14    22    21    20    30    27    
     12    17    17    14    22    21    20    30    27    
     12    17    17    14    22    21    20    30    27    
     12    17    17    14    22    21    20    30    27    

C1   14    18    18    30    37    26    58    66    37    
     14    18    17    30    36    26    58    66    37    
     14    18    17    30    36    26    58    66    37    
     14    18    17    30    36    26    58    66    37    

bg   12    17    17    14    22    21    20    30    27    
     12    17    17    14    22    21    20    30    27    
     12    17    17    14    22    21    20    30    27    
     12    17    17    14    22    21    20    30    27    

C2   13    19    18    23    43    37    44    88    62    
     13    19    18    23    43    37    44    88    62    
     13    19    18    23    43    37    44    88    62    
     13    19    18    23    43    37    44    88    62    

bg   12    17    17    14    22    22    20    30    28    
     12    17    17    14    22    22    20    30    28    
     12    17    17    14    22    22    20    30    28    
     12    17    17    14    22    22    20    30    28    

C3   13    18    18    16    33    38    23    55    68    
     13    18    18    16    33    38    23    55    68    
     13    18    18    16    33    38    23    56    68    
     13    18    18    16    33    38    23    56    68    

bg   12    17    17    14    22    22    20    30    28    
     12    17    17    14    22    22    20    30    28    
     12    17    17    14    23    22    20    30    28    
     12    17    17    14    23    22    20    30    28    


Trial #7-------------------------

     A1    A2    A3    B1    B2    B3    C1    C2    C3    

A1   48    51    26    29    37    26    22    32    29    
     48    51    26    29    37    26    22    32    29    
     48    51    26    29    37    26    23    32    29    
     48    51    26    29    37    26    22    32    29    

bg   12    17    17    14    23    22    20    31    28    
     12    17    17    14    23    22    20    31    28    
     12    17    17    14    23    22    20    30    28    
     12    17    17    14    23    22    20    30    28    

A2   34    71    50    24    45    36    22    33    30    
     34    71    50    24    45    36    22    33    30    
     34    71    50    24    45    36    22    33    30    
     34    71    50    24    45    36    22    33    30    

bg   12    17    17    14    23    22    20    31    28    
     12    17    17    14    23    22    20    31    28    
     12    17    17    14    23    22    20    31    28    
     12    17    17    14    23    22    20    30    28    

A3   15    41    57    16    34    37    21    32    30    
     15    41    57    16    34    37    21    32    30    
     15    41    57    16    34    37    21    32    30    
     15    41    57    16    34    37    21    32    30    

bg   12    17    17    14    23    22    20    31    28    
     12    17    17    14    23    22    20    31    28    
     12    17    17    14    23    22    20    30    28    
     12    17    17    14    23    22    20    30    28    

B1   27    31    21    50    55    30    36    45    32    
     27    31    21    50    55    30    36    45    32    
     27    31    21    50    55    30    36    45    32    
     27    31    21    50    55    30    36    45    32    

bg   12    17    17    14    23    22    20    31    28    
     12    17    17    14    23    22    20    30    28    
     12    17    17    14    23    22    20    30    28    
     12    17    17    14    23    22    20    30    28    

B2   22    39    31    35    78    56    29    50    42    
     22    39    31    35    78    56    29    50    42    
     22    39    31    35    78    56    29    50    42    
     22    39    31    35    78    56    29    50    42    

bg   12    17    17    14    23    22    20    30    28    
     12    17    17    14    23    22    20    30    28    
     12    17    17    14    23    22    20    30    28    
     12    17    17    14    23    22    20    31    28    

B3   14    28    33    17    49    63    22    43    47    
     14    28    33    17    49    63    22    43    47    
     14    28    33    17    49    63    22    43    47    
     14    28    33    17    49    63    22    43    47    

bg   12    17    17    14    23    22    20    31    28    
     12    17    17    14    23    22    20    31    28    
     12    17    17    14    23    22    20    31    28    
     12    17    17    14    23    22    20    31    28    

C1   14    19    18    30    37    27    59    67    38    
     14    19    18    30    37    27    59    67    38    
     14    19    18    30    37    27    59    67    38    
     14    19    18    30    37    27    59    66    38    

bg   12    17    17    14    23    22    20    31    28    
     12    17    17    14    23    22    20    31    28    
     12    17    17    14    23    22    20    31    28    
     12    17    17    14    23    22    20    30    28    

C2   13    19    18    24    44    37    44    89    62    
     13    19    18    24    44    37    45    89    62    
     13    19    18    24    44    37    45    89    62    
     13    19    18    24    44    37    45    89    62    

bg   12    17    17    14    23    22    20    31    28    
     12    17    17    14    23    22    20    31    28    
     12    17    17    14    23    22    20    31    28    
     12    17    17    14    23    22    20    31    28    

C3   13    18    19    16    33    38    23    56    69    
     13    18    19    16    33    38    23    56    69    
     13    18    19    16    33    38    23    56    69    
     13    18    19    16    33    38    23    56    69    

bg   12    17    17    14    23    22    20    31    28    
     12    17    17    14    23    22    20    31    28    
     12    17    17    14    23    22    20    31    28    
     12    17    17    14    23    22    20    31    28    


Trial #8-------------------------

     A1    A2    A3    B1    B2    B3    C1    C2    C3    

A1   48    51    26    29    37    26    23    32    29    
     48    51    26    29    37    26    23    33    29    
     48    51    26    29    37    26    23    33    29    
     48    51    26    29    37    26    23    32    29    

bg   12    17    17    14    23    22    20    31    28    
     12    17    17    14    23    22    20    31    28    
     12    17    17    14    23    22    20    31    28    
     12    17    17    14    23    22    20    31    28    

A2   34    70    50    24    45    36    22    33    30    
     34    70    50    24    45    36    22    33    30    
     34    70    50    24    45    36    22    33    30    
     34    70    50    24    45    36    22    33    30    

bg   12    17    17    14    23    22    20    31    28    
     12    17    17    14    23    22    20    31    28    
     12    17    17    14    23    22    20    31    28    
     12    17    17    14    23    22    20    31    28    

A3   15    41    57    16    34    37    21    32    30    
     15    41    57    16    34    37    21    32    30    
     15    41    57    16    34    37    21    32    30    
     15    41    57    16    34    37    21    32    30    

bg   12    17    17    14    23    22    20    30    28    
     12    17    17    14    23    22    20    31    28    
     12    17    17    14    23    22    20    31    28    
     12    17    17    14    23    22    20    31    28    

B1   26    31    21    49    54    30    36    45    32    
     26    31    21    49    54    30    36    45    32    
     26    31    21    49    54    30    36    45    32    
     26    31    21    49    54    30    36    45    32    

bg   12    17    17    14    23    22    20    31    28    
     12    17    17    14    23    22    20    31    28    
     12    17    17    14    23    22    20    31    28    
     12    17    17    14    23    22    20    31    28    

B2   22    39    31    35    78    56    30    50    42    
     22    39    31    35    78    56    30    50    42    
     22    39    31    35    78    56    30    50    42    
     22    39    31    35    78    56    30    50    42    

bg   12    17    17    14    23    22    20    31    28    
     12    17    17    14    23    22    20    31    28    
     12    17    17    14    23    22    20    31    28    
     12    17    17    14    23    22    20    31    28    

B3   14    28    33    17    49    63    22    43    47    
     14    28    33    17    49    63    23    43    47    
     14    28    33    17    49    63    22    43    47    
     14    28    33    17    49    63    22    43    47    

bg   12    17    17    14    23    22    20    31    28    
     12    17    17    14    23    22    20    31    28    
     12    17    17    14    23    22    20    31    28    
     12    17    17    14    23    22    20    31    28    

C1   14    19    18    30    37    27    59    67    38    
     14    19    18    30    37    27    59    67    38    
     14    19    18    30    37    27    59    67    38    
     14    19    18    30    37    27    59    66    38    

bg   12    17    17    14    23    22    21    31    28    
     12    17    17    15    23    22    21    31    28    
     12    17    17    14    23    22    21    31    28    
     12    17    17    14    23    22    20    31    28    

C2   13    19    18    24    44    37    45    89    63    
     13    19    18    24    44    37    45    89    63    
     13    19    18    24    44    37    45    89    63    
     13    19    18    24    44    37    45    89    63    

bg   12    17    17    14    23    22    21    31    28    
     12    17    17    14    23    22    20    31    28    
     12    17    17    14    23    22    20    31    28    
     12    17    17    14    23    22    20    31    28    

C3   13    18    19    16    33    38    23    56    69    
     13    18    19    16    33    38    23    56    69    
     13    18    19    16    33    38    23    56    69    
     13    18    19    16    33    38    23    56    69    

bg   12    17    17    15    23    22    21    31    28    
     12    17    17    14    23    22    20    31    28    
     12    17    17    14    23    22    20    31    28    
     12    17    17    14    23    22    20    31    28    

