     A1    A2    A3    B1    B2    B3    C1    C2    C3    

A1   71    61    14    27    24    7     4     3     2     
     71    61    14    27    24    7     4     3     2     
     70    61    14    27    24    7     4     3     2     
     70    61    14    27    24    7     4     3     2     

bg   0     0     0     0     0     0     0     0     0     
     0     0     0     0     0     0     0     0     0     
     0     0     0     0     0     0     0     0     0     
     0     0     0     0     0     0     0     0     0     

A2   43    111   69    18    44    28    3     5     3     
     43    111   69    18    44    28    3     5     3     
     43    111   69    18    44    28    3     5     3     
     43    111   69    18    44    28    3     5     3     

bg   0     0     0     0     0     0     0     0     0     
     0     0     0     0     0     0     0     0     0     
     0     0     0     0     0     0     0     0     0     
     0     0     0     0     0     0     0     0     0     

A3   7     54    81    4     25    32    2     3     4     
     7     54    80    4     25    32    2     3     4     
     7     54    80    4     25    32    2     3     4     
     7     54    80    4     25    32    2     3     4     

bg   0     0     0     0     0     0     0     0     0     
     0     0     0     0     0     0     0     0     0     
     0     0     0     0     0     0     0     0     0     
     0     0     0     0     0     0     0     0     0     

B1   31    27    7     74    65    17    35    30    8     
     31    27    7     74    65    17    35    30    8     
     31    27    7     74    65    17    35    30    8     
     31    27    7     74    65    17    35    30    8     

bg   0     0     0     0     0     0     0     0     0     
     0     0     0     0     0     0     0     0     0     
     0     0     0     0     0     0     0     0     0     
     0     0     0     0     0     0     0     0     0     

B2   18    42    27    40    110   67    21    42    27    
     18    41    27    40    110   67    21    42    27    
     18    41    27    40    109   67    21    42    27    
     18    41    27    40    109   67    21    42    27    

bg   0     0     0     0     0     0     0     0     0     
     0     0     0     0     0     0     0     0     0     
     0     0     0     0     0     0     0     0     0     
     0     0     0     0     0     0     0     0     0     

B3   3     19    27    5     50    76    4     23    34    
     3     19    28    5     50    76    4     23    33    
     3     19    28    5     50    76    4     23    33    
     3     19    28    5     50    76    4     23    33    

bg   0     0     0     0     0     0     0     0     0     
     0     0     0     0     0     0     0     0     0     
     0     0     0     0     0     0     0     0     0     
     0     0     0     0     0     0     0     0     0     

C1   4     4     2     33    32    11    79    70    22    
     4     4     2     33    32    11    79    70    22    
     4     4     2     33    32    11    79    70    22    
     4     4     2     33    32    11    79    70    22    

bg   0     0     0     0     0     0     0     0     0     
     0     0     0     0     0     0     0     0     0     
     0     0     0     0     0     0     0     0     0     
     0     0     0     0     0     0     0     0     0     

C2   3     5     3     22    49    33    53    110   68    
     3     5     3     22    49    33    53    110   67    
     3     5     3     22    49    33    52    110   67    
     3     5     3     22    49    33    52    109   67    

bg   0     0     0     0     0     0     0     0     0     
     0     0     0     0     0     0     0     0     0     
     0     0     0     0     0     0     0     0     0     
     0     0     0     0     0     0     0     0     0     

C3   1     3     3     3     23    31    8     49    72    
     1     3     3     3     23    31    8     49    72    
     1     3     3     3     23    31    8     49    72    
     1     3     3     3     23    32    8     49    72    

bg   0     0     0     0     0     0     0     0     0     
     0     0     0     0     0     0     0     0     0     
     0     0     0     0     0     0     0     0     0     
     0     0     0     0     0     0     0     0     0     
