     A1    A2    A3    B1    B2    B3    C1    C2    C3    

A1   386   529   370   371   548   390   347   470   347   
     387   529   370   371   548   390   347   470   347   
     387   529   370   371   549   390   347   470   347   
     387   529   371   371   549   391   348   471   347   

bg   320   472   358   347   527   385   345   469   347   
     320   472   358   347   527   385   345   469   347   
     320   472   359   347   528   386   345   469   347   
     320   473   359   347   528   386   345   470   347   

A2   364   585   429   366   574   415   350   475   351   
     364   585   429   367   573   415   350   476   351   
     364   585   429   366   574   415   350   476   351   
     364   586   429   367   574   415   350   476   351   

bg   322   476   361   350   531   388   347   472   349   
     322   476   361   350   531   389   348   472   349   
     322   476   361   350   532   389   348   472   349   
     323   477   362   350   532   389   348   473   349   

A3   332   534   445   356   560   424   352   479   356   
     332   534   445   356   560   424   352   479   356   
     332   534   445   356   561   424   352   479   356   
     332   534   445   356   561   424   352   479   356   

bg   326   481   365   353   537   393   351   477   352   
     326   481   365   353   537   393   351   477   353   
     326   482   365   354   537   393   351   477   353   
     326   482   366   354   537   393   351   478   353   

B1   358   510   373   428   603   410   387   508   362   
     358   510   373   428   603   410   387   508   362   
     358   510   374   428   603   410   387   509   362   
     358   510   374   428   603   410   387   508   362   

bg   327   484   367   355   540   395   353   480   354   
     328   484   367   355   540   395   353   479   354   
     328   484   367   355   540   395   353   480   354   
     328   484   367   355   540   395   353   480   355   

B2   346   526   395   396   651   463   374   523   382   
     346   526   395   396   651   463   374   523   382   
     346   526   395   396   651   463   374   523   382   
     346   526   395   396   651   462   374   523   382   

bg   329   486   369   357   542   396   354   481   356   
     329   486   369   357   542   397   354   482   356   
     329   486   369   357   542   396   354   482   356   
     329   486   369   357   542   397   354   482   356   

B3   332   506   397   362   593   474   359   506   390   
     332   506   397   362   593   474   359   506   390   
     332   506   397   362   593   474   359   506   390   
     332   506   397   362   593   474   359   506   390   

bg   330   488   371   358   544   398   355   483   357   
     330   488   371   358   544   398   356   483   357   
     330   488   371   358   544   398   356   483   357   
     330   488   371   358   544   398   356   483   357   

C1   335   492   373   391   577   410   436   555   379   
     334   492   373   391   577   410   435   554   379   
     334   492   373   391   577   410   436   554   379   
     334   492   373   391   577   410   436   555   379   

bg   331   489   372   359   546   399   357   485   358   
     331   489   372   359   546   399   356   485   358   
     331   490   372   359   546   399   356   485   359   
     331   490   372   359   546   399   357   485   358   

C2   334   495   376   381   595   433   410   596   427   
     335   495   375   381   596   433   410   596   427   
     335   495   376   381   595   433   410   595   426   
     335   495   376   381   595   433   410   595   426   

bg   332   491   373   360   547   400   358   486   359   
     332   491   373   360   547   401   358   486   359   
     332   491   373   360   547   401   358   486   360   
     332   491   373   360   547   401   358   486   360   

C3   334   494   376   364   570   432   366   536   432   
     334   494   377   364   570   432   366   536   432   
     334   494   377   364   571   432   366   536   432   
     334   494   377   364   571   432   366   536   432   

bg   333   493   374   361   549   402   359   487   360   
     333   493   374   361   549   402   359   487   360   
     333   493   374   361   549   402   359   487   360   
     333   493   374   361   549   402   359   488   360   
