     A1    A2    A3    B1    B2    B3    C1    C2    C3    

A1   402   554   391   389   576   412   365   495   366   
     402   554   391   389   576   412   365   495   366   
     402   554   391   389   576   412   365   494   366   
     402   554   391   389   576   412   365   494   366   

bg   336   497   378   364   554   406   362   492   364   
     336   497   378   364   554   406   362   492   364   
     336   497   378   364   553   406   362   492   364   
     336   497   378   364   554   406   362   492   364   

A2   379   608   447   382   598   434   365   497   368   
     379   608   447   382   598   434   365   497   368   
     379   608   447   382   598   434   365   496   368   
     379   608   447   382   598   434   365   497   368   

bg   336   497   378   364   554   406   362   492   364   
     336   497   378   364   554   406   362   492   365   
     336   497   378   364   554   406   362   492   364   
     336   497   378   364   554   406   362   492   365   

A3   343   551   459   368   579   439   364   496   369   
     344   551   459   368   579   438   364   496   369   
     343   551   459   368   579   438   364   496   369   
     343   551   459   368   579   438   364   496   369   

bg   337   498   379   365   554   406   362   493   365   
     337   498   379   365   554   406   362   492   365   
     337   498   379   365   554   407   362   492   365   
     337   498   379   364   554   407   362   493   365   

B1   368   525   386   439   619   423   397   523   373   
     367   525   386   439   619   423   397   523   373   
     368   525   386   439   619   423   397   523   373   
     368   525   386   439   619   423   397   523   373   

bg   337   498   379   365   555   407   362   493   365   
     337   498   379   365   555   407   363   493   365   
     337   499   379   365   555   407   363   493   365   
     337   498   379   365   555   407   363   493   365   

B2   355   540   406   405   666   474   384   535   392   
     355   540   406   405   666   474   383   536   392   
     355   540   406   405   665   474   383   536   392   
     355   540   406   405   665   474   383   536   392   

bg   337   499   379   365   555   407   363   493   365   
     337   499   379   365   555   407   363   493   365   
     337   499   379   365   555   407   363   493   366   
     337   499   379   365   555   407   363   493   365   

B3   340   518   407   370   605   484   367   517   399   
     340   517   407   370   605   484   367   517   399   
     340   518   407   370   605   484   367   517   399   
     340   517   407   370   605   484   367   517   399   

bg   337   499   380   365   556   408   363   494   366   
     337   499   380   365   556   408   363   494   366   
     337   499   380   365   556   408   363   494   366   
     337   499   380   365   556   408   363   494   366   

C1   341   502   382   398   588   419   442   563   387   
     341   502   382   398   588   419   442   563   387   
     341   503   382   398   588   419   442   563   387   
     341   503   382   398   588   419   442   563   387   

bg   337   499   380   365   556   408   363   494   366   
     337   499   380   365   556   408   363   494   366   
     337   499   380   365   556   408   363   494   366   
     337   499   380   365   556   408   363   494   366   

C2   340   504   383   387   605   441   416   605   434   
     340   504   383   387   605   441   416   604   434   
     340   504   383   387   605   441   416   604   433   
     340   504   383   387   605   441   416   604   433   

bg   337   499   380   365   556   408   363   494   366   
     337   499   380   365   556   408   363   494   366   
     337   499   380   365   556   408   363   494   366   
     337   499   380   365   556   408   363   494   366   

C3   339   502   383   369   578   439   371   543   438   
     338   502   383   368   578   439   371   543   438   
     339   502   383   368   578   439   371   543   438   
     338   502   383   369   579   439   371   543   438   

bg   337   499   380   365   556   408   363   494   366   
     337   499   380   365   556   408   363   494   366   
     337   499   380   365   556   408   363   494   366   
     337   499   380   365   556   408   363   494   366   
