     A1    A2    A3    B1    B2    B3    C1    C2    C3    

A1   404   557   394   391   579   415   367   497   368   
     404   557   394   390   579   415   367   497   368   
     404   557   394   390   579   415   367   497   368   
     404   557   394   390   579   415   367   497   368   

bg   337   500   381   365   557   409   363   495   367   
     338   500   381   365   557   409   364   495   367   
     337   500   381   365   557   409   363   495   367   
     337   500   381   366   556   409   363   495   367   

A2   380   611   449   383   601   437   367   499   370   
     380   611   449   383   601   437   367   499   370   
     380   611   449   383   601   437   367   499   370   
     380   611   450   383   601   437   367   499   370   

bg   338   500   381   365   557   409   364   495   367   
     338   500   381   366   557   409   364   495   367   
     338   500   381   366   557   409   363   495   367   
     338   500   381   366   557   409   364   495   367   

A3   344   554   461   369   582   441   365   498   371   
     345   554   461   369   582   441   365   498   371   
     345   554   461   369   582   441   365   498   371   
     344   554   461   369   582   441   365   498   371   

bg   337   500   381   365   557   409   363   495   367   
     337   500   381   365   556   409   363   495   367   
     338   500   381   366   557   409   364   495   367   
     337   500   381   365   557   409   363   495   367   

B1   368   527   388   439   622   425   398   525   375   
     368   527   388   439   621   425   398   525   375   
     368   527   388   439   621   425   398   524   375   
     368   527   388   439   621   425   398   525   375   

bg   337   500   381   365   557   409   363   495   367   
     337   500   381   365   557   409   363   495   367   
     337   500   381   365   557   409   363   495   367   
     337   500   381   366   557   409   363   495   367   

B2   355   541   408   405   667   476   384   537   394   
     355   541   408   405   667   476   384   537   394   
     355   541   408   405   667   476   384   537   394   
     355   541   408   405   667   476   384   537   394   

bg   337   500   381   365   557   409   363   495   367   
     337   500   381   365   557   409   364   495   367   
     337   500   381   365   557   409   363   495   367   
     338   500   381   365   557   409   363   495   367   

B3   340   519   408   370   607   486   368   518   401   
     340   519   408   370   607   485   368   518   400   
     340   519   408   370   607   485   368   518   401   
     340   519   409   370   607   485   368   518   401   

bg   338   500   381   365   557   409   364   495   367   
     338   500   381   365   557   409   364   495   367   
     338   500   381   365   557   409   363   495   367   
     338   500   381   365   557   409   363   495   367   

C1   341   504   383   398   589   420   442   565   388   
     341   504   383   398   589   420   442   565   388   
     341   504   383   398   589   420   442   565   388   
     341   504   383   398   589   421   442   565   388   

bg   338   500   381   365   557   409   363   495   367   
     337   500   381   365   557   409   363   495   367   
     338   500   381   365   557   409   363   495   367   
     338   500   381   365   557   409   363   495   367   

C2   340   505   384   387   606   442   416   606   435   
     340   505   384   387   606   442   416   605   435   
     340   505   384   387   606   442   416   605   435   
     340   505   384   387   606   442   416   604   434   

bg   337   501   381   365   557   409   363   495   367   
     338   500   381   365   557   409   363   495   367   
     338   500   381   365   557   409   364   495   367   
     338   500   381   365   557   409   363   495   367   

C3   339   503   384   369   580   441   371   544   439   
     339   503   384   369   580   441   371   544   439   
     339   503   384   369   580   441   371   544   439   
     339   503   384   369   580   441   371   544   439   

bg   338   501   382   366   557   410   363   495   367   
     338   501   382   365   557   409   364   495   367   
     338   500   381   366   557   409   364   495   367   
     338   501   382   365   557   410   364   495   367   
