     A1    A2    A3    B1    B2    B3    C1    C2    C3    

A1   305   407   276   283   414   292   263   355   262   
     305   408   277   284   415   292   263   356   262   
     305   408   277   284   415   293   264   356   262   
     306   409   278   284   416   293   264   356   263   

bg   241   354   268   262   398   290   263   358   264   
     241   355   268   262   398   291   264   358   265   
     242   355   268   263   399   291   264   359   265   
     242   356   269   263   399   292   265   359   265   

A2   288   471   341   284   449   323   271   369   272   
     288   472   341   285   449   324   272   369   272   
     289   472   342   285   450   324   272   370   273   
     289   473   342   286   450   325   273   370   273   

bg   249   367   277   271   412   301   273   371   273   
     250   368   278   272   412   301   273   371   274   
     250   368   278   272   413   302   274   372   274   
     251   369   279   273   414   302   274   372   275   

A3   261   427   363   280   444   338   279   380   283   
     261   428   363   280   445   338   280   381   283   
     262   428   364   281   446   339   280   381   283   
     262   429   364   281   446   340   280   382   284   

bg   258   380   287   281   426   311   282   383   283   
     259   381   288   281   427   312   282   384   283   
     259   381   288   282   428   312   283   384   284   
     259   382   289   282   428   313   283   385   284   

B1   293   413   299   359   498   333   321   419   296   
     294   414   300   360   499   333   321   420   296   
     294   415   300   360   499   334   322   420   296   
     295   415   301   361   500   334   322   421   297   

bg   267   393   297   290   441   322   291   396   292   
     268   394   298   291   441   322   292   397   293   
     268   394   298   291   442   323   292   397   293   
     268   395   299   292   443   323   292   397   293   

B2   289   441   329   335   558   394   316   444   324   
     289   441   329   335   559   394   317   444   324   
     290   442   330   335   559   395   317   445   324   
     290   442   330   336   559   395   317   445   325   

bg   275   405   307   299   454   332   299   407   300   
     275   406   307   299   455   332   300   408   301   
     276   406   307   300   455   333   300   408   301   
     276   407   308   300   456   333   301   408   302   

B3   281   429   338   308   510   413   307   436   338   
     282   430   339   308   510   413   308   436   338   
     282   430   339   308   511   413   308   437   338   
     282   431   339   309   511   414   308   437   339   

bg   282   416   315   307   466   340   307   417   308   
     283   416   315   307   466   341   307   418   308   
     283   417   316   307   467   341   307   418   309   
     283   417   316   307   467   341   308   418   309   

C1   289   424   321   343   503   355   389   492   333   
     289   425   321   343   504   356   389   492   333   
     290   425   321   343   505   356   390   493   333   
     290   426   322   344   505   357   390   493   334   

bg   289   426   322   314   476   348   313   426   315   
     289   426   323   314   477   348   314   427   315   
     289   426   323   314   477   349   314   427   315   
     290   427   323   314   478   349   314   427   316   

C2   294   434   329   338   530   385   369   541   386   
     295   435   329   338   531   385   369   541   386   
     295   435   330   339   531   385   370   541   386   
     295   436   330   339   532   385   370   541   386   

bg   295   434   329   320   486   355   319   434   321   
     295   435   329   320   487   356   320   435   321   
     295   435   330   320   487   356   320   435   321   
     295   435   330   321   487   356   320   435   322   

C3   298   441   335   326   513   390   330   487   396   
     299   441   336   326   513   390   330   487   396   
     299   442   336   327   514   390   330   488   396   
     299   442   336   327   514   391   331   488   396   

bg   300   442   335   326   495   361   325   442   326   
     300   443   335   326   495   362   325   442   327   
     300   443   336   326   495   362   325   442   327   
     300   443   336   326   496   362   325   443   327   
