Trial #1-------------------------

     A1    A2    A3    B1    B2    B3    C1    C2    C3    

A1   155   181   124   124   177   143   135   202   180   
     155   181   124   124   177   144   134   202   180   
     154   180   124   123   177   144   134   202   180   
     153   180   124   123   176   143   134   201   180   

bg   78    108   104   91    145   134   129   197   177   
     77    108   104   91    145   134   129   196   177   
     77    108   104   91    145   134   129   196   177   
     77    108   104   91    145   133   128   196   176   

A2   124   220   173   111   192   162   131   199   179   
     124   220   172   111   191   161   131   199   178   
     123   220   172   111   191   161   131   199   178   
     123   220   172   110   191   161   131   199   178   

bg   76    106   102   90    142   131   127   193   174   
     76    106   102   90    142   131   126   193   174   
     76    106   103   90    142   132   126   193   174   
     76    106   103   90    142   132   126   193   174   

A3   83    158   188   94    166   163   128   197   178   
     84    158   188   94    167   163   129   197   179   
     84    159   188   94    167   164   129   197   179   
     84    159   188   95    168   164   130   198   179   

bg   78    108   104   92    145   134   129   197   177   
     78    108   105   92    146   134   130   198   178   
     78    109   105   92    146   135   130   198   179   
     79    109   106   93    147   136   131   199   179   

B1   110   140   115   168   216   155   165   232   191   
     110   140   116   168   216   155   165   232   191   
     110   141   116   169   217   156   165   233   192   
     110   141   116   169   217   156   166   234   192   

bg   81    113   109   96    152   139   135   205   184   
     81    113   109   96    152   140   135   206   185   
     82    113   109   96    152   140   136   207   186   
     82    114   110   97    153   141   136   207   186   

B2   102   161   140   140   270   213   155   249   216   
     102   161   140   140   270   213   155   249   216   
     103   161   140   140   270   213   155   250   216   
     103   161   141   140   270   213   156   250   217   

bg   82    115   111   97    154   142   137   208   188   
     82    115   111   97    154   142   137   209   188   
     83    115   111   97    154   142   137   209   188   
     83    115   111   98    154   142   137   209   188   

B3   87    139   144   104   212   229   142   236   227   
     87    139   145   104   212   229   142   236   228   
     87    139   145   105   212   229   142   236   228   
     87    139   145   105   212   230   142   236   229   

bg   83    116   112   98    156   144   138   211   190   
     84    116   112   98    156   144   138   211   191   
     84    116   112   99    156   144   139   211   190   
     83    116   112   98    156   143   138   211   190   

C1   86    119   113   131   185   153   219   286   209   
     86    119   113   130   185   153   218   285   208   
     86    118   113   130   184   152   218   285   208   
     86    118   113   130   184   152   218   285   208   

bg   83    115   111   97    154   142   137   209   188   
     83    115   111   97    154   142   137   209   188   
     83    115   111   97    154   143   137   209   189   
     83    115   111   97    154   143   137   209   189   

C2   85    119   114   117   200   175   189   334   261   
     85    119   114   118   200   175   189   334   261   
     85    119   114   118   200   175   189   334   261   
     85    119   114   118   200   175   189   334   261   

bg   83    115   111   98    155   142   138   209   188   
     83    115   111   98    154   142   137   209   188   
     83    115   111   97    154   142   137   209   188   
     82    114   111   97    154   142   136   208   187   

C3   83    117   114   100   175   176   142   261   273   
     84    117   114   100   176   176   142   262   273   
     84    117   114   100   176   176   142   261   273   
     84    117   113   100   176   176   142   261   272   

bg   82    114   110   97    154   141   137   208   187   
     82    114   110   97    154   141   137   208   187   
     82    114   110   97    153   141   137   208   187   
     82    114   110   97    153   141   137   208   187   


Trial #2-------------------------

     A1    A2    A3    B1    B2    B3    C1    C2    C3    

A1   158   185   129   128   184   150   140   211   189   
     157   185   129   127   184   150   140   211   189   
     157   185   129   127   184   150   140   211   189   
     157   185   129   127   183   150   140   211   189   

bg   82    114   110   97    153   141   136   207   187   
     82    114   110   97    153   141   136   207   186   
     82    114   110   97    153   141   136   208   186   
     82    114   110   97    153   141   137   208   187   

A2   129   228   180   117   201   171   140   212   190   
     129   228   180   117   201   171   140   213   191   
     129   228   180   117   201   171   140   213   191   
     129   228   180   117   201   171   140   213   191   

bg   82    114   111   97    154   142   136   208   188   
     82    114   111   97    154   142   136   208   188   
     82    114   110   97    154   142   136   208   187   
     82    114   110   97    153   141   136   208   187   

A3   89    166   194   100   176   172   138   210   190   
     89    166   194   100   176   172   138   210   190   
     89    166   194   100   176   172   138   210   190   
     89    165   194   100   176   171   137   209   190   

bg   81    112   109   95    151   139   134   205   184   
     81    112   109   95    151   139   134   204   184   
     81    112   109   95    151   139   134   204   184   
     81    112   108   95    151   139   134   204   184   

B1   111   141   116   170   218   156   166   234   192   
     111   141   116   170   218   156   167   234   192   
     111   142   116   170   218   156   167   235   192   
     111   141   116   170   218   156   167   234   192   

bg   81    112   108   95    151   139   134   204   183   
     80    112   108   95    150   138   134   204   183   
     80    111   108   95    150   138   133   203   183   
     80    111   108   94    150   138   133   203   183   

B2   101   158   138   138   267   210   152   245   212   
     101   158   138   138   267   210   152   245   212   
     101   158   138   138   267   210   152   245   212   
     101   159   138   138   267   209   153   245   212   

bg   81    112   108   95    150   138   134   203   183   
     81    112   108   95    150   138   134   203   183   
     81    112   108   95    150   138   134   204   183   
     81    112   108   95    150   138   134   204   183   

B3   85    136   142   102   208   226   139   231   224   
     85    136   142   102   208   226   139   231   224   
     85    136   143   102   208   227   139   232   225   
     85    137   143   103   209   227   140   232   225   

bg   82    114   110   97    153   141   136   207   186   
     82    114   110   97    153   141   136   207   186   
     82    114   110   97    153   141   136   207   186   
     82    114   110   97    153   141   136   207   186   

C1   85    117   112   129   183   151   216   283   206   
     85    117   112   129   183   151   216   283   206   
     85    117   112   129   183   151   216   283   206   
     85    117   112   128   183   151   215   283   206   

bg   82    114   110   96    152   141   135   207   186   
     82    113   110   96    152   141   135   206   186   
     82    113   110   96    152   140   135   206   186   
     82    113   110   96    152   140   136   207   186   

C2   84    117   112   115   196   171   186   329   257   
     83    117   111   115   196   171   185   328   256   
     83    116   111   115   196   171   185   327   256   
     83    116   111   115   195   171   185   327   255   

bg   80    112   108   95    150   138   133   203   183   
     80    111   108   94    149   138   133   202   182   
     80    111   107   94    149   138   132   202   182   
     79    111   107   94    149   137   132   201   181   

C3   80    112   109   96    169   170   137   253   264   
     80    112   109   96    169   170   137   253   264   
     80    112   109   96    169   170   137   253   264   
     80    112   108   96    169   169   137   252   263   

bg   78    108   105   92    146   134   130   197   178   
     78    109   105   92    146   134   130   198   178   
     78    109   105   92    146   135   130   198   178   
     78    109   105   92    146   135   130   198   178   


Trial #3-------------------------

     A1    A2    A3    B1    B2    B3    C1    C2    C3    

A1   154   181   124   123   177   144   134   202   181   
     154   180   124   123   177   144   134   202   181   
     154   180   124   123   177   144   134   202   181   
     154   180   124   123   177   144   134   202   180   

bg   79    109   105   93    147   135   130   199   178   
     79    109   105   93    147   135   131   199   178   
     79    109   105   93    147   135   130   199   178   
     79    109   105   93    147   135   130   199   179   

A2   125   223   175   112   194   164   133   203   182   
     125   222   175   112   194   164   133   202   182   
     124   222   174   111   193   163   132   201   181   
     124   221   174   111   192   163   132   201   180   

bg   77    107   103   91    144   132   128   195   175   
     77    107   103   91    143   132   127   194   174   
     77    106   103   90    143   131   127   193   174   
     76    106   102   90    142   131   127   193   173   

A3   83    157   186   93    165   161   127   194   176   
     83    157   186   92    164   161   127   194   176   
     82    156   185   92    164   161   126   193   175   
     82    156   185   92    163   160   126   192   175   

bg   75    104   100   88    139   129   124   188   170   
     74    103   100   88    139   128   123   188   170   
     74    103   100   88    139   128   123   188   169   
     74    103   100   88    139   127   123   187   169   

B1   104   131   107   161   205   144   155   216   176   
     103   131   106   160   203   143   154   215   175   
     103   130   106   160   203   143   154   215   175   
     103   130   106   160   202   142   153   214   174   

bg   72    100   97    85    135   124   120   182   164   
     72    100   97    85    134   124   119   182   164   
     72    100   96    85    134   124   119   181   164   
     72    99    96    84    134   123   119   181   163   

B2   92    145   125   127   250   193   137   221   190   
     91    145   125   127   249   193   137   221   190   
     91    145   125   127   249   192   137   220   189   
     91    145   124   127   248   192   136   220   189   

bg   70    97    94    82    131   120   116   177   159   
     70    97    94    82    130   120   116   176   158   
     69    96    93    82    129   119   115   175   158   
     69    96    93    81    129   119   114   175   157   

B3   72    118   125   87    184   204   117   198   194   
     72    118   124   86    183   203   117   197   193   
     71    117   124   86    183   202   116   196   192   
     71    117   123   86    182   201   116   195   191   

bg   66    92    89    78    123   114   110   167   150   
     66    91    88    78    123   113   109   166   149   
     66    91    88    77    122   112   109   165   148   
     65    91    88    77    122   112   108   164   148   

C1   67    93    88    108   150   121   186   238   166   
     67    92    88    107   149   120   186   237   165   
     67    92    87    107   149   120   185   236   165   
     66    91    87    107   148   119   185   236   164   

bg   63    88    85    74    118   108   105   159   143   
     63    87    84    74    117   108   104   159   142   
     62    87    84    73    117   107   104   157   141   
     62    86    83    73    115   106   103   155   140   

C2   63    88    84    91    157   136   151   276   209   
     62    87    84    90    157   135   150   275   209   
     62    87    83    90    156   135   150   274   208   
     62    87    83    90    156   135   150   274   208   

bg   60    83    80    70    111   103   99    151   136   
     60    84    81    71    112   103   100   152   136   
     60    84    81    71    112   104   100   152   137   
     61    84    81    71    113   104   100   152   137   

C3   61    86    84    74    134   137   106   205   221   
     61    86    84    74    134   137   106   205   221   
     62    86    84    74    134   138   106   205   222   
     62    86    84    74    134   138   106   206   222   

bg   61    85    82    72    114   105   101   154   138   
     61    85    82    72    114   105   101   154   139   
     61    85    83    72    115   106   102   155   140   
     62    86    83    73    115   106   102   156   141   


Trial #4-------------------------

     A1    A2    A3    B1    B2    B3    C1    C2    C3    

A1   139   159   103   105   148   117   108   162   145   
     139   159   104   106   149   117   109   163   145   
     139   160   104   106   149   118   110   164   146   
     139   160   104   106   149   118   110   164   146   

bg   64    89    86    76    120   111   107   163   146   
     65    90    87    76    121   111   107   163   147   
     65    90    87    76    121   112   107   164   147   
     65    90    87    76    121   112   108   164   148   

A2   112   205   158   97    170   142   112   170   152   
     113   205   158   97    170   142   112   170   153   
     113   205   158   98    171   143   112   171   153   
     113   205   158   98    171   143   113   171   154   

bg   67    93    89    79    124   115   111   168   151   
     67    93    90    79    125   115   111   169   152   
     67    93    90    79    125   115   111   169   152   
     67    93    90    79    125   115   111   169   152   

A3   74    145   175   83    149   147   113   173   157   
     74    145   175   83    149   147   113   173   157   
     74    145   175   83    149   147   113   173   157   
     74    145   175   83    149   147   113   173   157   

bg   68    94    90    80    126   116   112   170   153   
     67    94    90    80    126   116   112   170   153   
     67    94    90    79    126   116   112   170   153   
     67    93    90    79    126   116   112   170   153   

B1   97    122   98    153   192   133   144   200   161   
     97    122   98    153   192   133   144   199   161   
     97    122   98    153   192   133   143   199   161   
     97    122   98    152   191   132   143   199   161   

bg   67    93    90    79    124   115   111   168   152   
     67    93    90    79    125   115   111   169   152   
     67    93    90    79    125   115   111   169   152   
     67    93    90    79    125   115   111   169   152   

B2   87    140   120   123   242   186   130   211   181   
     87    140   120   122   242   186   130   211   181   
     87    140   120   122   241   186   130   210   181   
     87    140   120   122   241   186   130   210   181   

bg   66    92    89    78    124   115   110   168   151   
     67    93    90    78    124   115   110   168   151   
     67    93    90    78    124   115   110   168   151   
     67    93    90    78    124   115   111   168   152   

B3   71    116   123   85    181   201   115   195   191   
     71    116   123   85    181   201   115   194   190   
     71    116   123   85    181   200   115   194   190   
     70    116   123   85    181   200   115   194   190   

bg   66    92    89    78    124   114   110   168   151   
     66    92    89    78    124   114   110   167   151   
     66    92    89    78    124   114   110   167   151   
     66    92    89    78    123   114   110   167   150   

C1   69    95    90    110   153   124   189   242   169   
     69    95    90    110   153   123   189   241   169   
     69    94    90    109   152   123   188   241   168   
     69    94    89    109   152   123   188   240   168   

bg   65    90    87    76    121   111   108   164   147   
     65    90    87    76    121   111   107   163   147   
     65    90    87    76    121   111   107   163   147   
     65    90    87    76    120   111   107   163   147   

C2   67    94    90    95    165   143   158   286   219   
     67    93    89    95    165   143   158   286   219   
     67    94    90    96    165   143   158   286   219   
     67    94    90    96    165   143   158   286   219   

bg   65    90    87    76    121   111   107   163   147   
     65    90    87    76    121   111   108   164   147   
     65    90    87    77    121   112   108   164   147   
     65    91    87    77    122   112   108   164   148   

C3   67    94    91    80    144   147   115   219   234   
     67    94    92    81    145   148   115   220   235   
     67    94    92    81    145   148   115   220   235   
     67    94    92    81    145   148   115   220   235   

bg   66    92    89    78    123   114   110   167   150   
     66    92    89    78    123   114   110   167   150   
     66    92    89    78    123   114   110   167   150   
     66    92    89    78    123   114   110   167   150   


