Trial #1-------------------------

     A1    A2    A3    B1    B2    B3    C1    C2    C3    

A1   164   194   137   135   195   160   150   226   202   
     163   193   137   135   195   160   150   227   203   
     163   194   137   135   196   161   151   227   204   
     163   194   138   135   196   162   151   228   205   

bg   88    123   119   104   166   153   147   225   203   
     88    123   119   104   165   152   147   224   201   
     88    123   118   104   165   151   147   224   201   
     88    122   118   104   164   151   147   223   200   

A2   135   235   187   124   212   179   150   227   203   
     134   235   187   124   212   179   149   227   203   
     134   235   187   123   211   180   149   227   203   
     134   235   187   123   211   180   149   226   203   

bg   87    121   118   103   163   151   145   222   200   
     87    121   118   103   163   151   145   221   200   
     87    121   117   103   163   151   145   221   200   
     87    121   117   103   163   150   145   221   199   

A3   94    173   201   106   186   180   146   223   201   
     94    173   200   106   186   180   147   223   201   
     94    172   200   106   186   180   147   223   201   
     94    172   200   106   186   180   147   223   201   

bg   87    121   117   103   163   150   145   221   198   
     87    121   117   102   163   150   145   220   199   
     87    121   117   102   163   150   144   221   199   
     87    121   117   102   163   150   144   220   199   

B1   117   150   125   177   230   167   177   251   208   
     117   151   125   177   230   167   178   251   208   
     118   151   125   178   230   167   178   252   208   
     118   151   126   178   231   168   179   252   208   

bg   88    122   117   104   164   150   147   223   199   
     88    122   117   104   164   150   146   222   199   
     87    121   117   103   164   150   146   222   199   
     87    121   117   103   163   150   145   221   199   

B2   107   168   147   146   280   222   164   263   229   
     107   168   147   146   280   222   164   263   228   
     107   168   147   146   280   222   164   263   228   
     108   168   147   146   280   221   164   262   228   

bg   87    121   117   103   163   149   145   221   198   
     87    121   117   103   163   149   146   221   198   
     87    121   117   103   163   149   146   221   198   
     87    121   117   103   163   150   146   221   198   

B3   91    145   150   109   220   237   149   247   238   
     91    145   151   109   220   237   149   247   238   
     90    144   151   109   219   237   149   246   238   
     91    145   151   109   219   237   149   246   238   

bg   87    121   117   103   163   150   145   221   199   
     87    121   117   103   163   150   145   221   199   
     87    121   117   103   163   150   145   221   198   
     87    121   117   103   163   150   146   221   198   

C1   91    125   119   136   194   160   227   298   219   
     91    125   119   136   194   161   226   298   219   
     91    125   119   136   194   161   226   297   219   
     91    125   119   136   194   161   225   298   220   

bg   87    122   118   103   164   152   146   222   201   
     87    122   118   103   164   151   146   222   200   
     87    122   118   103   163   151   145   221   200   
     87    122   118   103   163   150   145   222   200   

C2   91    128   122   125   211   184   199   350   275   
     92    128   123   126   213   186   201   352   276   
     92    129   123   126   213   186   201   352   276   
     92    128   123   126   213   186   200   351   276   

bg   88    122   118   103   164   151   146   223   200   
     87    122   118   103   163   151   145   222   200   
     87    121   117   103   163   150   145   221   199   
     87    121   117   102   162   150   144   220   199   

C3   88    124   120   106   185   184   151   274   284   
     88    124   120   106   185   184   151   274   284   
     88    124   120   106   185   184   151   274   283   
     89    124   120   107   185   184   152   275   283   

bg   88    122   117   104   164   150   146   222   199   
     88    122   117   104   164   150   146   222   199   
     87    122   117   103   163   150   146   221   199   
     87    122   117   103   163   150   145   221   199   


Trial #2-------------------------

     A1    A2    A3    B1    B2    B3    C1    C2    C3    

A1   162   193   136   133   193   159   149   224   201   
     162   193   136   134   194   159   149   225   202   
     162   193   136   134   194   159   149   225   202   
     162   192   136   134   194   159   149   225   201   

bg   87    121   117   103   163   150   146   221   198   
     87    121   117   103   163   150   146   221   198   
     88    122   117   104   164   150   146   222   199   
     88    123   118   104   165   151   147   223   200   

A2   136   238   190   125   215   183   152   231   208   
     135   238   190   125   215   183   151   230   207   
     135   237   189   124   213   182   150   228   206   
     134   235   188   122   211   180   148   226   203   

bg   85    119   115   101   160   148   142   217   195   
     85    119   115   101   160   147   142   217   195   
     85    119   114   101   160   146   142   216   194   
     85    119   114   101   160   146   142   216   194   

A3   92    170   198   104   182   177   143   218   197   
     92    170   198   104   182   177   143   218   197   
     92    170   198   103   182   177   143   218   197   
     92    170   198   103   182   177   142   218   197   

bg   85    118   115   100   159   147   141   216   195   
     85    119   115   101   160   148   142   217   196   
     86    119   116   101   161   148   143   218   197   
     86    120   116   102   161   148   143   219   197   

B1   117   149   124   177   229   165   177   249   205   
     117   149   124   177   229   165   177   249   205   
     117   149   124   177   228   165   177   249   204   
     117   149   124   177   228   165   177   249   205   

bg   86    120   116   102   162   149   144   219   197   
     86    121   117   102   162   150   144   220   198   
     86    121   117   102   162   150   144   220   199   
     86    121   117   102   162   150   144   220   199   

B2   107   167   146   146   280   221   163   262   227   
     107   167   146   146   279   220   163   261   226   
     107   168   146   146   279   220   164   261   226   
     107   168   146   146   279   220   164   262   226   

bg   87    121   116   103   162   149   145   220   197   
     87    121   117   103   162   149   145   220   198   
     87    121   117   103   162   150   145   220   198   
     87    121   117   102   162   150   144   220   198   

B3   90    144   151   109   219   237   149   246   238   
     90    144   150   109   219   237   149   246   238   
     90    144   150   109   219   236   149   246   237   
     90    144   150   109   219   235   149   246   237   

bg   87    121   116   103   162   149   145   220   197   
     87    121   116   102   162   148   145   219   196   
     87    120   116   102   162   148   144   219   196   
     86    120   116   102   161   148   144   219   196   

C1   89    123   118   134   192   159   223   295   217   
     89    123   118   134   191   159   223   294   217   
     89    123   118   134   191   159   222   294   217   
     89    123   118   134   191   159   222   294   217   

bg   86    120   116   102   161   148   143   218   196   
     86    120   116   102   161   148   143   218   196   
     86    120   115   102   161   148   143   218   196   
     86    120   115   102   161   147   144   218   195   

C2   89    124   119   122   207   180   195   343   269   
     88    124   118   121   206   180   195   342   269   
     88    124   118   121   206   180   194   342   269   
     88    124   118   121   206   181   194   342   269   

bg   85    119   116   101   160   148   143   218   196   
     86    119   116   101   160   148   143   218   196   
     86    120   116   101   161   148   143   218   196   
     86    120   116   102   161   148   143   218   196   

C3   88    122   119   105   183   182   150   272   281   
     88    122   119   105   183   182   150   272   281   
     88    122   119   105   183   182   150   272   281   
     88    123   119   105   184   183   150   272   281   

bg   86    120   116   102   161   149   143   219   197   
     86    120   116   102   161   149   143   219   197   
     86    120   116   102   161   149   143   219   198   
     86    120   116   101   161   149   143   218   197   


Trial #3-------------------------

     A1    A2    A3    B1    B2    B3    C1    C2    C3    

A1   162   191   134   132   191   156   147   221   197   
     162   191   134   132   191   156   147   221   197   
     162   191   134   133   191   156   147   221   197   
     162   191   134   133   191   156   148   221   197   

bg   86    119   115   102   161   148   143   218   196   
     86    119   115   102   161   148   143   218   196   
     86    119   115   101   161   148   143   218   196   
     86    119   115   101   160   148   143   217   196   

A2   132   233   186   121   208   178   146   222   200   
     132   233   185   121   208   177   146   222   200   
     132   233   185   121   208   177   146   222   200   
     133   233   185   121   208   177   146   222   199   

bg   86    119   115   102   161   147   143   218   195   
     86    119   115   102   161   147   143   218   195   
     86    119   115   102   161   147   143   218   195   
     86    119   115   101   161   147   143   218   195   

A3   93    171   200   104   184   179   144   220   200   
     93    171   200   104   184   179   144   220   200   
     92    171   200   104   183   179   144   220   200   
     92    171   200   104   183   179   144   220   200   

bg   86    119   115   101   160   147   143   218   195   
     86    119   115   101   160   147   143   217   195   
     86    119   115   101   160   147   143   217   195   
     86    119   115   101   160   147   143   217   195   

B1   115   147   122   175   226   163   174   246   202   
     114   147   122   174   225   163   174   245   202   
     114   146   121   173   224   162   173   243   201   
     113   146   121   172   223   162   172   242   200   

bg   83    115   111   98    155   143   138   210   189   
     82    115   111   97    154   142   137   209   188   
     82    114   110   97    154   141   137   208   187   
     82    114   109   96    153   141   136   207   186   

B2   102   160   138   139   269   210   154   247   213   
     101   159   138   139   268   210   154   246   212   
     101   159   138   139   268   209   154   246   212   
     101   159   138   139   267   209   153   246   212   

bg   81    112   109   95    151   139   134   204   184   
     81    113   109   95    151   140   134   205   185   
     81    113   110   96    152   140   135   206   186   
     82    114   110   96    153   141   136   207   187   

B3   87    139   145   104   212   229   142   236   228   
     87    139   145   105   212   229   143   236   228   
     87    139   145   105   213   229   143   237   228   
     88    140   145   106   213   229   144   237   229   

bg   85    118   114   100   158   146   141   214   193   
     85    118   114   100   159   146   141   216   194   
     85    119   115   101   160   147   142   216   195   
     86    119   115   101   160   148   142   217   196   

C1   89    124   118   134   192   160   223   295   218   
     90    124   119   135   193   160   224   296   219   
     90    125   119   135   193   161   225   297   219   
     90    125   119   135   193   160   225   297   219   

bg   87    121   116   103   163   149   145   220   198   
     87    121   116   103   162   149   145   220   197   
     87    121   116   102   162   149   145   220   197   
     86    120   116   102   161   148   144   219   196   

C2   88    123   118   121   205   180   193   341   268   
     88    123   118   121   205   180   193   340   268   
     88    123   118   121   205   180   193   340   268   
     88    123   118   121   205   180   193   340   268   

bg   85    118   114   100   159   146   142   216   194   
     85    118   114   100   159   146   142   215   193   
     85    118   113   100   158   145   141   215   192   
     85    118   113   100   158   145   141   214   192   

C3   86    120   117   103   180   179   147   267   277   
     86    120   116   103   180   179   146   267   277   
     85    120   116   102   179   179   146   267   277   
     85    120   116   102   179   180   146   267   278   

bg   84    117   113   99    158   145   140   214   193   
     84    117   113   100   158   146   140   214   193   
     84    118   114   100   158   146   141   215   193   
     85    118   114   100   158   145   141   215   193   


Trial #4-------------------------

     A1    A2    A3    B1    B2    B3    C1    C2    C3    

A1   162   190   133   132   190   154   146   219   195   
     162   190   133   132   190   155   146   219   195   
     161   190   133   132   190   155   146   219   196   
     161   190   133   132   190   155   146   219   196   

bg   85    119   115   101   160   147   142   216   195   
     85    119   115   101   160   147   142   217   195   
     85    119   115   101   160   147   142   217   195   
     85    119   115   101   160   147   142   216   195   

A2   132   232   184   120   207   176   145   221   198   
     132   231   183   120   207   175   145   220   197   
     132   231   183   120   207   175   145   220   197   
     132   231   183   120   206   175   145   220   197   

bg   85    118   114   100   159   146   142   215   193   
     85    118   114   100   159   146   141   215   194   
     85    118   114   100   159   146   141   215   194   
     85    118   114   100   159   147   141   215   194   

A3   91    169   199   103   182   177   142   218   198   
     92    169   198   103   182   177   143   218   198   
     92    169   198   103   182   177   143   218   197   
     92    169   197   104   182   176   143   218   197   

bg   85    118   114   100   158   145   141   215   192   
     85    118   114   100   158   145   141   215   192   
     85    118   114   100   158   145   141   215   193   
     85    118   114   100   158   146   141   215   193   

B1   114   147   122   174   225   163   173   245   202   
     114   147   122   173   225   163   173   245   202   
     114   147   122   173   225   163   173   245   202   
     114   147   122   173   225   163   173   245   202   

bg   85    118   113   100   158   145   141   214   192   
     85    118   113   100   158   145   141   214   192   
     85    117   113   100   158   145   141   214   192   
     85    117   113   100   158   145   141   214   192   

B2   105   164   143   143   275   217   160   256   221   
     105   164   143   143   275   217   160   256   222   
     105   164   144   143   274   217   160   256   222   
     105   164   144   143   274   217   159   256   222   

bg   84    118   114   100   158   146   140   214   193   
     85    118   114   100   158   145   141   214   193   
     85    118   114   100   158   146   141   215   193   
     85    118   114   100   158   146   141   215   193   

B3   89    142   147   107   216   232   146   241   232   
     89    142   147   107   216   232   146   242   232   
     89    142   148   107   216   232   146   242   233   
     89    142   148   107   216   233   146   242   233   

bg   85    119   115   100   159   147   142   216   195   
     85    119   115   101   159   147   142   216   195   
     85    119   115   100   159   147   142   216   195   
     85    119   115   101   159   147   142   216   195   

C1   89    122   116   134   190   157   223   293   214   
     89    122   116   134   190   157   223   293   214   
     89    122   116   134   190   157   223   293   214   
     89    122   116   134   190   157   223   293   214   

bg   85    119   115   101   160   147   142   217   195   
     85    119   115   101   160   147   142   217   195   
     85    119   115   101   160   147   142   217   195   
     85    119   115   101   160   147   142   216   195   

C2   88    123   118   121   205   179   193   340   268   
     88    123   118   121   205   179   193   340   267   
     88    123   118   121   205   179   193   340   267   
     88    123   117   121   205   179   193   340   266   

bg   86    120   115   102   161   148   143   219   196   
     86    119   115   101   160   147   143   218   196   
     86    119   115   102   161   148   143   217   195   
     85    118   114   100   159   146   142   216   194   

C3   86    121   117   103   181   181   147   268   279   
     86    120   117   103   180   180   146   268   279   
     86    121   117   103   181   181   147   269   279   
     86    121   117   103   180   180   147   268   278   

bg   85    118   114   100   159   146   142   215   193   
     85    118   114   100   159   146   142   215   193   
     85    118   114   100   159   145   141   215   193   
     85    118   114   100   159   145   141   215   193   


