Trial #1-------------------------

     A1    A2    A3    B1    B2    B3    C1    C2    C3    

A1   162   189   132   132   189   154   146   218   194   
     162   189   132   132   189   154   146   218   194   
     161   189   132   132   189   155   146   218   194   
     161   189   133   132   189   155   146   218   195   

bg   85    118   114   100   158   146   141   214   192   
     85    118   114   100   158   146   141   214   193   
     85    118   114   100   158   146   141   214   193   
     85    118   114   100   158   146   141   214   192   

A2   132   230   182   121   206   175   145   219   196   
     132   230   182   121   206   175   145   219   195   
     132   230   182   121   206   174   145   219   195   
     132   230   182   121   206   174   145   219   195   

bg   85    118   114   101   158   146   142   214   192   
     85    118   114   101   159   146   141   214   193   
     85    118   114   100   158   146   141   214   193   
     85    118   114   100   158   146   141   214   193   

A3   92    169   198   104   182   177   143   217   197   
     92    169   198   104   182   177   143   217   196   
     92    169   197   104   181   177   143   217   196   
     92    169   197   104   181   176   143   217   195   

bg   86    118   113   101   158   145   142   214   191   
     85    118   114   101   158   145   142   214   191   
     85    118   114   101   158   145   142   214   192   
     85    118   114   101   158   146   141   214   192   

B1   115   147   122   174   225   164   173   245   202   
     115   147   122   174   225   164   174   245   202   
     115   147   122   174   225   164   174   245   202   
     115   147   122   174   225   164   174   245   202   

bg   86    118   114   101   159   146   142   215   192   
     86    118   114   101   158   145   142   214   191   
     86    118   114   101   159   145   142   215   191   
     86    118   114   101   159   146   142   215   192   

B2   106   165   144   144   275   217   161   257   222   
     106   165   144   144   275   217   161   257   222   
     106   165   144   144   275   217   161   257   222   
     106   164   144   144   275   217   160   256   222   

bg   85    118   114   100   158   146   141   214   192   
     85    118   114   101   158   146   141   214   192   
     85    118   114   101   158   146   141   214   192   
     85    118   113   101   158   145   142   214   191   

B3   89    141   146   107   214   230   146   240   229   
     89    141   146   107   214   230   146   239   230   
     89    141   146   107   214   231   145   239   230   
     89    141   147   107   214   231   145   239   231   

bg   85    118   114   100   158   146   141   214   193   
     85    118   114   100   158   146   141   214   193   
     85    118   114   101   159   146   141   215   193   
     85    118   114   101   159   146   142   215   193   

C1   89    121   116   133   188   156   222   290   211   
     89    121   115   133   188   155   222   289   211   
     89    121   115   133   188   155   222   289   211   
     89    121   115   133   188   155   221   289   211   

bg   85    118   114   100   158   145   141   214   192   
     85    117   114   100   158   146   141   214   192   
     85    117   114   100   158   146   141   214   192   
     85    117   114   100   158   146   141   214   192   

C2   87    121   117   120   202   177   191   336   264   
     88    122   117   120   202   177   191   336   263   
     88    122   116   120   203   177   192   336   263   
     88    122   116   120   203   177   192   337   263   

bg   86    118   114   101   159   146   142   215   192   
     86    118   114   101   159   146   142   215   192   
     86    118   114   101   159   147   142   215   193   
     86    118   114   101   159   147   142   215   193   

C3   87    121   117   104   180   181   147   268   278   
     86    120   117   103   180   181   147   267   278   
     87    120   117   103   180   180   147   267   277   
     87    121   117   104   180   180   147   267   277   

bg   85    118   114   101   158   145   142   214   191   
     85    118   114   101   158   145   142   214   191   
     85    118   113   101   158   145   142   214   191   
     85    118   113   101   158   145   141   214   191   


Trial #2-------------------------

     A1    A2    A3    B1    B2    B3    C1    C2    C3    

A1   161   189   132   131   189   154   145   217   194   
     160   189   132   131   189   154   145   217   194   
     160   189   132   131   189   155   145   217   194   
     160   188   132   131   188   155   145   217   194   

bg   85    118   114   100   158   146   141   214   192   
     85    118   114   101   158   145   141   214   192   
     85    118   114   101   158   145   142   214   192   
     86    118   114   101   159   145   142   214   192   

A2   132   231   183   121   207   175   145   219   196   
     132   231   183   121   206   175   145   219   196   
     132   231   183   121   207   176   145   220   197   
     132   231   184   121   207   176   146   220   198   

bg   86    119   115   101   159   147   142   216   194   
     86    119   115   101   159   147   142   216   194   
     86    119   115   101   159   147   142   216   194   
     86    119   115   101   159   147   142   216   193   

A3   93    170   198   105   183   177   144   219   197   
     93    170   197   105   182   177   144   218   196   
     93    169   197   105   182   177   144   218   196   
     93    169   197   105   182   177   144   218   196   

bg   85    118   114   101   159   146   142   215   193   
     85    118   114   101   159   147   142   215   193   
     85    118   114   101   159   147   141   215   193   
     85    118   114   100   158   146   141   214   193   

B1   115   147   122   175   225   163   174   245   201   
     115   147   122   175   225   163   174   244   201   
     115   147   122   175   225   163   174   244   200   
     115   147   122   175   225   162   175   244   200   

bg   85    117   113   101   158   145   141   214   191   
     85    117   113   100   158   145   141   214   191   
     85    117   113   100   158   145   141   213   191   
     85    117   113   100   158   145   141   213   191   

B2   105   164   144   143   275   217   160   255   221   
     106   164   144   144   275   217   160   256   222   
     106   165   144   144   275   217   161   256   222   
     106   165   144   144   275   217   161   257   222   

bg   86    118   114   101   159   146   142   215   192   
     85    118   114   101   159   145   142   215   192   
     85    118   114   101   159   145   142   214   191   
     85    118   114   101   158   145   142   214   191   

B3   89    141   148   107   215   232   146   241   232   
     90    142   148   108   216   233   147   242   233   
     90    142   148   108   216   234   147   242   234   
     90    142   148   108   216   234   147   242   234   

bg   85    118   114   101   158   146   141   214   192   
     85    118   114   101   158   145   141   214   191   
     85    117   113   101   158   145   141   214   191   
     85    118   113   101   158   145   142   214   191   

C1   89    121   115   133   188   156   222   290   211   
     89    121   116   133   188   156   221   290   212   
     89    121   116   133   188   156   221   290   212   
     89    121   116   133   188   156   221   289   212   

bg   85    118   114   100   158   146   141   214   193   
     85    118   114   100   158   146   141   214   192   
     85    118   114   100   158   146   141   214   192   
     85    118   114   101   158   146   141   214   192   

C2   88    122   117   121   203   177   193   338   264   
     88    122   117   121   203   177   193   338   263   
     88    122   117   121   203   177   193   337   263   
     88    122   117   120   203   177   192   337   264   

bg   85    118   114   100   158   146   141   214   192   
     85    118   114   100   158   146   141   214   192   
     85    118   114   100   158   146   141   214   193   
     85    118   114   100   158   146   141   214   193   

C3   87    120   117   104   180   180   147   268   277   
     87    120   117   104   180   180   148   268   276   
     87    120   117   104   180   179   148   268   276   
     87    120   117   104   180   179   148   268   276   

bg   85    118   114   101   158   145   142   214   191   
     85    118   114   101   158   145   142   214   192   
     85    118   114   100   158   146   141   214   192   
     85    118   114   100   158   146   141   214   192   


Trial #3-------------------------

     A1    A2    A3    B1    B2    B3    C1    C2    C3    

A1   160   189   133   131   189   155   146   218   195   
     160   189   133   132   189   155   146   219   195   
     160   189   133   132   190   155   147   219   196   
     161   189   133   132   190   155   147   219   195   

bg   86    118   114   101   159   146   142   215   192   
     86    118   114   101   158   145   142   214   191   
     86    118   114   101   158   145   142   215   191   
     85    118   114   101   158   145   142   214   192   

A2   131   231   183   120   206   175   144   219   196   
     131   231   183   120   206   175   144   219   196   
     131   231   183   120   206   175   144   219   196   
     131   231   183   120   206   175   144   219   196   

bg   85    118   114   101   158   146   142   214   192   
     85    118   114   101   158   146   142   215   192   
     86    118   114   101   158   145   142   215   192   
     86    118   114   101   158   145   142   214   191   

A3   92    169   197   104   181   176   143   217   195   
     92    169   197   104   181   177   143   217   196   
     92    169   198   104   181   177   143   217   196   
     92    169   198   104   182   177   143   217   196   

bg   86    119   115   101   160   147   142   216   194   
     86    119   115   101   160   148   143   217   195   
     86    119   115   102   160   148   143   217   195   
     86    119   115   102   161   148   144   217   195   

B1   116   148   122   176   226   163   175   246   201   
     116   148   122   176   226   163   175   246   201   
     116   147   122   175   226   163   175   245   201   
     115   147   122   175   225   163   175   245   201   

bg   85    118   114   101   158   146   141   214   193   
     85    118   114   101   158   146   141   214   193   
     85    118   114   100   158   146   141   214   193   
     85    118   114   100   158   146   141   214   193   

B2   106   165   144   145   276   218   161   257   222   
     106   165   144   145   276   217   162   257   222   
     107   165   144   145   276   217   162   258   221   
     107   165   144   145   276   217   162   257   221   

bg   85    118   114   101   158   146   142   214   192   
     85    118   114   100   158   146   141   214   192   
     85    118   114   100   158   146   141   214   192   
     85    118   114   100   158   146   141   214   192   

B3   89    141   147   107   215   233   146   240   232   
     89    141   147   107   214   232   145   240   231   
     89    141   147   107   214   231   145   240   231   
     89    141   147   107   214   231   146   240   230   

bg   85    118   113   101   158   145   141   214   191   
     85    117   113   101   158   145   141   214   191   
     85    117   113   101   158   145   141   214   191   
     85    117   113   100   158   145   141   214   191   

C1   88    120   115   132   187   156   220   288   211   
     88    120   115   132   187   155   219   288   211   
     87    120   114   131   186   155   219   287   210   
     87    119   114   131   186   154   218   286   209   

bg   84    116   112   99    155   143   139   211   188   
     84    116   112   99    156   143   140   211   189   
     85    116   112   100   157   144   140   212   189   
     85    117   113   100   157   144   141   213   190   

C2   88    122   117   120   203   177   192   338   264   
     88    122   117   120   203   178   192   338   264   
     88    122   117   120   203   178   192   338   265   
     88    122   117   120   203   178   192   338   265   

bg   85    118   114   100   158   146   141   214   193   
     85    118   114   101   158   146   141   215   192   
     85    118   114   101   159   146   142   215   192   
     85    118   114   101   159   146   142   215   192   

C3   87    121   117   105   181   180   149   269   277   
     87    121   118   105   182   180   149   269   277   
     87    121   118   105   182   181   149   269   278   
     87    121   118   105   182   181   149   269   278   

bg   85    118   114   101   159   146   141   215   193   
     85    118   114   101   159   146   141   215   193   
     85    118   114   101   159   146   141   215   193   
     85    118   114   101   159   146   142   215   193   


Trial #4-------------------------

     A1    A2    A3    B1    B2    B3    C1    C2    C3    

A1   162   190   133   132   190   155   146   219   195   
     161   189   132   132   189   154   146   218   194   
     161   189   132   132   189   154   146   218   194   
     161   189   132   132   189   154   146   218   194   

bg   85    118   114   101   159   146   142   215   192   
     85    118   114   101   158   146   141   214   192   
     85    118   114   100   158   146   141   214   192   
     85    118   114   100   158   146   141   214   193   

A2   132   232   184   120   206   176   144   219   196   
     132   231   184   121   207   176   145   219   196   
     132   231   183   121   207   176   145   220   196   
     132   232   184   121   207   176   145   220   196   

bg   86    118   114   101   158   145   142   215   192   
     85    118   114   101   158   145   142   214   191   
     85    118   113   100   158   145   141   214   191   
     85    118   113   100   158   145   141   214   191   

A3   91    168   198   103   180   176   142   216   195   
     92    168   198   103   181   176   142   216   195   
     92    169   198   103   181   177   142   216   196   
     92    169   198   104   181   177   143   217   196   

bg   86    118   114   101   159   146   142   215   192   
     86    118   114   101   159   146   142   215   192   
     86    118   114   101   159   146   142   215   192   
     86    118   114   101   159   146   142   215   192   

B1   115   147   122   175   225   163   174   245   201   
     115   147   122   174   225   163   174   244   201   
     115   147   122   174   225   163   174   244   201   
     115   147   122   174   225   163   173   244   201   

bg   85    118   114   100   158   146   141   214   192   
     85    118   114   101   158   146   142   215   192   
     85    118   114   101   159   146   142   215   192   
     85    118   114   101   159   146   142   215   192   

B2   106   165   144   145   276   217   162   257   221   
     106   165   144   145   276   217   162   257   221   
     106   165   144   145   276   217   162   257   222   
     106   165   144   145   276   218   162   257   222   

bg   85    118   114   101   159   146   142   215   193   
     85    118   114   101   159   146   141   215   193   
     85    118   114   101   159   146   142   215   193   
     85    118   114   101   159   146   142   215   193   

B3   89    141   147   107   215   231   146   240   230   
     89    141   147   107   215   231   146   240   230   
     89    141   147   107   215   231   146   240   230   
     89    141   147   107   215   231   146   240   230   

bg   86    118   114   101   159   146   142   215   193   
     85    118   114   101   158   146   141   214   192   
     85    118   114   101   158   146   141   214   193   
     85    118   114   101   159   146   142   215   193   

C1   89    122   116   133   189   157   222   291   213   
     89    122   116   133   189   157   222   291   213   
     89    121   116   133   189   156   222   290   212   
     89    121   116   133   189   156   222   290   212   

bg   85    118   114   101   158   145   142   214   191   
     85    118   114   101   158   146   142   215   192   
     85    118   114   101   158   146   142   215   192   
     86    118   114   101   159   146   142   215   193   

C2   88    122   117   120   203   178   192   338   265   
     88    122   117   120   203   178   192   338   265   
     88    122   117   120   203   178   192   337   265   
     88    122   117   120   203   178   192   337   264   

bg   85    118   114   101   158   145   141   214   191   
     85    118   114   101   158   145   142   214   191   
     85    118   114   101   158   145   142   214   191   
     86    118   114   101   158   145   142   215   192   

C3   87    121   117   104   181   180   148   268   277   
     87    121   117   104   181   180   148   268   278   
     87    121   117   104   181   181   148   268   278   
     87    121   117   104   181   181   147   268   278   

bg   85    118   114   101   159   146   142   215   193   
     85    118   114   101   159   146   142   215   192   
     85    118   114   101   158   146   142   214   192   
     85    118   114   101   158   145   142   214   192   


