Trial #1-------------------------

     A1    A2    A3    B1    B2    B3    C1    C2    C3    

A1   161   189   134   131   188   157   145   217   196   
     161   189   134   131   188   157   145   217   196   
     160   188   134   130   188   158   145   217   197   
     159   188   134   130   188   158   144   217   198   

bg   83    117   116   99    158   150   139   214   196   
     83    117   116   99    158   150   140   214   196   
     83    117   116   99    158   150   140   214   196   
     84    117   116   99    158   149   140   214   196   

A2   130   230   185   119   206   178   144   219   198   
     130   230   184   119   205   177   144   218   197   
     130   230   184   119   205   177   144   218   197   
     130   229   184   119   205   177   144   218   197   

bg   83    117   115   99    157   149   140   213   195   
     83    116   115   98    157   149   139   212   195   
     83    116   115   98    157   149   139   212   195   
     82    116   115   98    156   148   138   212   194   

A3   89    167   199   101   178   178   139   213   197   
     89    167   198   101   178   178   139   213   196   
     89    166   197   101   178   177   140   213   195   
     89    166   196   101   178   177   140   213   195   

bg   83    115   113   98    155   146   138   210   191   
     82    115   113   98    155   146   138   210   191   
     82    115   113   97    155   146   137   210   191   
     82    115   114   97    155   146   137   210   192   

B1   111   143   122   169   221   164   168   239   201   
     111   144   122   170   221   164   168   239   201   
     111   144   122   170   221   164   169   239   201   
     112   144   122   170   221   164   169   239   200   

bg   82    115   113   98    155   146   138   210   190   
     82    115   113   98    155   145   138   210   190   
     82    115   113   98    155   146   138   210   190   
     82    115   113   98    155   146   138   210   191   

B2   103   162   144   141   272   218   157   252   221   
     102   162   144   141   272   219   157   252   222   
     103   162   144   141   272   219   157   252   222   
     103   162   145   141   272   219   156   252   222   

bg   82    115   114   98    155   147   138   210   192   
     82    115   114   98    155   147   138   210   192   
     83    116   114   98    156   147   139   211   192   
     83    116   114   98    156   147   139   211   192   

B3   87    139   147   105   213   232   144   237   231   
     87    139   148   105   213   233   143   237   232   
     87    140   148   105   213   234   143   238   233   
     87    140   148   105   213   234   143   238   233   

bg   82    116   115   98    156   148   138   212   194   
     83    116   115   98    156   148   138   212   194   
     83    116   115   98    157   148   139   212   194   
     83    117   115   99    157   148   139   213   194   

C1   87    121   117   132   188   159   222   290   214   
     87    121   117   132   188   159   222   290   214   
     87    121   117   132   188   159   222   289   214   
     87    120   117   132   188   158   221   289   214   

bg   83    117   115   98    157   148   139   212   194   
     83    116   115   98    157   148   139   212   194   
     83    117   116   98    157   149   139   213   195   
     83    116   115   98    156   149   138   212   195   

C2   86    121   119   118   202   181   191   337   267   
     86    121   118   119   203   181   191   337   267   
     86    121   118   119   203   181   192   337   266   
     86    121   118   119   203   180   192   337   266   

bg   84    117   115   99    157   148   140   213   194   
     83    117   115   99    157   148   140   213   194   
     83    117   115   99    157   148   139   213   194   
     83    117   115   98    157   149   139   213   195   

C3   84    119   119   101   179   184   145   266   282   
     85    120   119   102   179   184   145   267   282   
     85    120   119   102   180   184   146   267   281   
     85    120   119   102   180   184   146   267   281   

bg   84    117   115   99    158   148   141   214   194   
     84    117   115   100   158   148   141   214   194   
     84    117   115   99    158   148   141   213   194   
     83    117   115   99    157   148   140   213   194   


Trial #2-------------------------

     A1    A2    A3    B1    B2    B3    C1    C2    C3    

A1   159   188   134   129   187   157   143   215   196   
     158   187   134   129   187   157   143   215   196   
     157   187   134   128   187   157   142   215   197   
     157   187   134   128   187   157   143   216   197   

bg   83    116   115   98    156   148   139   212   194   
     83    116   115   99    157   148   139   212   193   
     83    116   114   99    156   147   139   212   193   
     83    116   114   99    156   147   140   212   192   

A2   129   229   183   118   204   176   142   216   196   
     129   229   184   118   203   176   142   216   196   
     129   229   184   117   203   176   141   215   196   
     129   229   184   117   203   177   141   215   197   

bg   82    115   114   97    155   147   137   210   193   
     82    115   114   97    155   147   137   210   193   
     82    115   114   97    155   147   138   211   193   
     82    115   114   98    155   147   138   211   192   

A3   90    167   197   102   179   177   141   214   196   
     90    167   197   102   179   177   140   214   196   
     89    167   197   101   179   177   140   213   196   
     89    167   197   101   179   177   140   213   196   

bg   82    116   114   97    155   147   138   211   193   
     82    116   114   97    156   148   138   211   193   
     82    116   115   97    156   148   138   211   193   
     82    116   115   97    156   148   138   211   193   

B1   113   145   122   172   223   165   171   242   202   
     113   145   122   173   223   164   172   242   202   
     113   145   122   173   223   164   172   242   201   
     113   145   122   173   223   164   172   242   201   

bg   83    116   114   98    156   147   139   212   193   
     83    116   115   98    156   148   139   212   193   
     83    116   115   98    156   148   139   212   193   
     83    116   115   98    156   148   138   211   194   

B2   103   164   146   142   274   221   158   255   224   
     104   165   146   143   276   222   159   257   225   
     103   163   146   142   274   219   158   254   223   
     104   163   145   142   274   219   158   254   222   

bg   84    117   115   99    157   148   140   213   193   
     84    117   115   99    157   148   140   213   194   
     84    117   115   99    158   148   141   214   194   
     84    117   116   99    158   149   141   214   195   

B3   88    141   150   106   215   237   145   240   236   
     88    141   150   106   215   238   145   240   237   
     88    141   151   106   215   238   145   241   237   
     88    141   151   106   215   238   145   241   237   

bg   84    118   117   100   159   150   141   215   197   
     84    118   116   100   159   150   142   215   196   
     85    118   116   100   159   150   142   215   196   
     85    118   116   100   159   150   142   215   196   

C1   88    122   118   133   189   160   222   291   216   
     88    122   118   132   189   161   222   291   217   
     87    121   118   132   189   160   220   291   217   
     87    121   118   131   189   161   219   290   217   

bg   84    118   117   99    158   150   140   215   197   
     84    118   117   99    159   150   141   215   197   
     84    118   116   100   159   150   141   215   196   
     84    118   116   100   159   150   141   215   196   

C2   87    122   119   120   204   181   193   339   268   
     87    122   119   120   204   181   193   338   267   
     87    122   119   120   204   181   192   338   267   
     86    122   119   119   203   181   192   338   267   

bg   83    117   116   99    158   150   140   214   196   
     83    117   116   99    158   150   140   214   196   
     83    117   116   99    158   150   140   214   196   
     83    117   116   99    157   149   139   213   196   

C3   85    120   119   102   180   183   146   267   280   
     85    120   119   102   180   183   146   267   279   
     85    120   119   103   180   183   146   267   278   
     85    119   118   102   179   182   146   266   278   

bg   83    116   114   98    156   147   139   211   192   
     82    115   114   98    155   147   138   210   192   
     82    115   114   97    155   146   137   210   192   
     82    115   114   97    155   147   137   210   192   


Trial #3-------------------------

     A1    A2    A3    B1    B2    B3    C1    C2    C3    

A1   158   187   133   128   186   157   142   214   196   
     159   188   134   129   187   157   143   216   197   
     159   188   135   130   188   158   144   217   198   
     160   189   135   131   189   158   145   218   198   

bg   85    118   116   101   160   150   142   216   196   
     84    117   115   100   158   149   141   214   194   
     84    117   115   99    157   148   140   213   194   
     83    117   115   99    157   148   140   213   194   

A2   130   230   185   118   205   179   142   218   199   
     130   230   185   118   205   178   142   218   199   
     129   230   185   118   205   178   142   217   199   
     129   230   185   118   204   178   142   217   198   

bg   83    116   115   99    157   148   139   212   193   
     83    116   115   99    157   148   140   212   193   
     83    117   115   99    157   148   140   212   193   
     83    117   115   99    157   148   140   212   193   

A3   90    168   199   102   180   179   141   215   198   
     90    168   199   102   180   179   141   215   198   
     90    168   200   102   180   180   140   215   198   
     90    168   200   102   180   180   140   215   199   

bg   83    117   116   99    157   149   139   213   195   
     83    117   116   99    157   149   140   213   195   
     84    117   116   99    158   149   140   214   195   
     84    117   116   99    158   149   141   214   195   

B1   115   147   124   175   226   166   174   245   204   
     115   147   124   175   226   166   174   245   204   
     114   147   124   175   226   167   174   245   204   
     114   147   124   174   226   167   174   245   205   

bg   84    118   117   100   159   151   141   216   198   
     84    118   117   100   159   151   141   216   198   
     84    118   117   99    159   151   141   215   197   
     84    118   116   99    158   150   140   215   197   

B2   105   165   146   144   276   221   160   257   225   
     105   165   146   144   276   221   161   257   225   
     105   165   146   144   276   221   161   257   225   
     105   165   146   144   276   221   161   257   225   

bg   84    118   116   100   159   150   141   215   196   
     84    118   116   100   158   150   141   215   196   
     84    118   116   99    158   150   141   215   196   
     84    118   116   99    158   150   140   214   197   

B3   88    141   150   106   215   237   145   241   236   
     88    141   150   106   216   237   145   241   236   
     88    142   150   106   216   237   146   241   236   
     88    142   150   107   216   236   146   241   235   

bg   84    118   116   100   159   150   142   215   196   
     84    118   116   100   159   149   141   215   195   
     84    118   116   100   158   149   141   214   195   
     84    117   116   99    158   149   141   214   195   

C1   87    121   118   131   188   160   220   290   216   
     87    121   118   131   188   160   219   290   216   
     87    121   118   131   188   160   219   290   216   
     87    121   118   131   188   160   219   290   216   

bg   84    117   116   99    158   149   140   214   195   
     84    117   115   99    158   149   141   214   194   
     84    117   115   100   158   148   141   214   194   
     84    117   115   100   158   148   141   214   194   

C2   86    122   119   119   203   181   192   338   268   
     86    121   119   119   203   181   191   338   268   
     86    121   119   119   203   181   191   337   268   
     86    121   119   118   202   181   190   337   268   

bg   83    117   116   99    157   149   139   213   195   
     83    117   115   99    157   149   140   213   195   
     83    117   115   99    157   149   140   213   194   
     84    117   115   99    157   148   140   213   194   

C3   85    119   118   102   179   182   146   267   278   
     85    120   119   102   180   183   146   267   279   
     85    120   119   102   180   183   146   267   279   
     85    120   119   102   180   184   146   267   280   

bg   83    117   116   99    158   149   140   214   196   
     83    117   116   99    158   149   140   214   196   
     83    117   116   99    158   149   140   214   196   
     83    117   116   99    158   149   140   214   195   


Trial #4-------------------------

     A1    A2    A3    B1    B2    B3    C1    C2    C3    

A1   161   189   134   131   189   157   144   217   197   
     161   189   134   131   188   157   145   217   196   
     161   188   134   131   188   157   145   217   196   
     160   188   134   130   188   157   144   217   196   

bg   83    117   115   99    157   148   140   213   194   
     83    117   115   99    157   149   140   213   195   
     83    117   116   99    157   149   139   213   195   
     83    117   115   98    157   149   139   213   195   

A2   129   230   185   118   205   178   142   217   198   
     130   230   185   118   205   178   142   217   198   
     130   230   184   119   205   178   143   217   198   
     130   230   184   119   205   178   143   218   198   

bg   84    117   115   99    158   148   141   214   194   
     84    117   115   99    158   148   140   214   194   
     84    117   115   99    158   149   140   213   194   
     83    117   115   99    157   149   140   213   195   

A3   90    168   201   102   180   181   141   216   199   
     90    168   201   102   180   181   141   216   199   
     90    168   201   102   181   180   141   216   199   
     90    169   200   102   181   181   141   216   200   

bg   84    117   115   99    158   149   140   214   194   
     84    117   115   99    157   148   140   214   194   
     84    117   116   100   158   149   141   214   195   
     84    117   115   99    157   148   140   213   194   

B1   114   146   124   174   225   166   173   244   204   
     114   146   124   173   225   167   172   244   204   
     113   146   124   173   224   166   172   243   204   
     113   146   124   172   224   166   171   243   204   

bg   83    117   116   99    158   149   140   213   195   
     84    117   116   99    158   149   140   214   195   
     84    117   116   100   158   149   141   214   195   
     84    117   116   100   158   149   141   214   195   

B2   105   164   146   143   275   220   160   256   224   
     105   164   146   143   275   220   160   256   224   
     104   164   146   143   274   220   160   256   224   
     104   164   146   143   274   220   160   256   224   

bg   84    117   116   99    158   150   140   214   196   
     84    117   116   99    158   149   140   214   196   
     84    117   116   99    158   149   140   214   196   
     84    117   116   99    158   149   140   214   196   

B3   88    141   149   106   214   234   145   240   234   
     88    141   149   106   214   234   145   240   233   
     88    141   149   106   214   234   145   240   233   
     88    141   149   106   214   234   145   240   233   

bg   84    117   116   99    158   149   140   214   195   
     84    117   116   99    158   150   140   214   196   
     84    117   116   99    158   150   140   214   196   
     84    118   116   99    158   150   140   214   196   

C1   87    121   118   132   189   160   220   291   216   
     87    121   118   132   189   160   221   291   216   
     87    121   118   132   189   160   221   291   216   
     87    121   118   132   189   160   222   291   215   

bg   84    118   116   100   158   149   141   215   195   
     84    118   116   100   158   149   141   215   195   
     84    118   116   100   158   150   141   215   196   
     84    118   116   100   158   150   141   215   196   

C2   86    122   120   119   204   183   192   339   270   
     86    122   120   119   204   183   192   339   270   
     86    122   120   119   204   183   192   339   269   
     87    122   119   119   204   182   192   339   269   

bg   84    118   116   100   159   150   141   215   196   
     84    118   116   100   159   149   141   215   195   
     84    118   116   100   159   149   141   215   195   
     84    118   116   100   159   149   141   215   196   

C3   86    120   120   103   181   185   147   269   282   
     85    120   120   103   181   185   147   268   283   
     85    120   120   103   181   185   146   268   283   
     85    120   120   102   180   185   146   268   282   

bg   84    118   117   100   159   150   141   215   197   
     84    118   116   100   158   150   141   214   196   
     84    117   116   100   158   149   141   214   195   
     84    118   116   100   158   149   141   215   195   


