     A1    A2    A3    B1    B2    B3    C1    C2    C3    

A1   132   148   100   103   146   120   115   162   146   
     132   149   100   103   147   121   116   163   147   
     132   149   100   103   147   121   116   164   148   
     132   149   100   103   146   120   115   163   147   

bg   63    89    86    77    122   113   110   158   144   
     64    90    87    78    124   114   112   160   146   
     64    90    87    78    124   115   112   160   146   
     64    90    87    78    123   114   112   160   145   

A2   108   202   157   97    169   144   117   168   152   
     108   203   157   97    170   144   117   169   152   
     106   200   154   95    166   141   114   163   148   
     106   200   154   95    166   141   114   163   148   

bg   64    89    86    77    123   114   111   160   145   
     64    90    86    78    123   114   111   160   145   
     63    89    86    77    123   114   111   159   145   
     64    90    87    78    123   114   112   160   145   

A3   71    144   168   82    149   147   114   164   150   
     71    143   167   81    148   146   113   163   150   
     71    143   167   81    148   146   113   163   149   
     71    143   167   81    147   146   113   162   149   

bg   63    89    86    77    123   113   111   159   145   
     64    89    86    77    123   114   111   159   145   
     63    89    86    77    122   113   111   159   144   
     63    89    86    77    122   113   111   158   144   

B1   94    116   93    151   187   130   145   189   152   
     94    117   93    151   188   130   146   189   153   
     94    116   93    151   187   129   145   188   152   
     94    116   93    151   186   129   145   188   152   

bg   63    89    86    77    122   113   111   159   144   
     63    89    86    77    122   113   111   159   144   
     63    89    86    77    122   113   111   159   144   
     63    89    86    77    122   113   111   159   144   

B2   81    130   112   116   232   180   131   201   171   
     81    130   112   116   232   180   131   201   171   
     81    130   113   117   232   180   132   202   172   
     82    131   113   117   232   181   133   203   173   

bg   64    90    87    78    124   115   112   161   146   
     65    91    88    79    125   116   113   163   148   
     64    90    86    78    123   114   111   160   145   
     64    90    86    77    123   114   111   159   145   

B3   66    108   114   82    173   190   116   183   179   
     66    108   114   82    173   190   115   183   178   
     66    108   114   82    172   190   115   183   178   
     66    108   114   82    173   190   116   183   178   

bg   64    89    86    77    123   114   111   159   145   
     63    89    86    77    123   113   111   159   145   
     63    89    86    77    122   113   111   159   144   
     63    89    86    77    122   113   111   159   144   

C1   67    93    88    110   155   124   191   230   166   
     67    92    88    110   154   124   190   229   165   
     67    93    88    110   155   125   191   230   166   
     68    93    89    111   156   126   192   231   167   

bg   63    89    86    77    122   113   111   159   144   
     63    89    86    77    122   113   111   158   144   
     64    89    86    77    123   113   111   159   145   
     64    90    87    78    123   114   112   160   146   

C2   66    94    90    99    172   146   164   270   213   
     66    94    89    99    172   146   164   270   212   
     66    94    89    99    171   146   163   269   212   
     66    94    89    99    171   146   163   269   211   

bg   64    89    86    77    123   114   111   160   145   
     64    90    87    78    123   114   111   160   145   
     64    89    86    77    123   113   111   159   145   
     64    90    86    78    123   114   111   160   145   

C3   65    92    90    81    146   145   119   209   217   
     65    92    90    81    146   146   120   209   218   
     65    93    90    81    146   146   120   210   218   
     66    93    91    82    147   146   120   211   219   

bg   63    89    86    77    122   113   111   159   144   
     63    89    86    77    122   113   111   159   144   
     63    89    86    77    122   113   110   158   144   
     63    89    86    77    122   113   110   158   144   
