     A1    A2    A3    B1    B2    B3    C1    C2    C3    

A1   136   156   105   106   154   126   122   175   154   
     132   148   99    102   145   119   114   161   145   
     132   148   99    103   145   119   114   162   146   
     132   148   99    102   145   119   114   161   145   

bg   63    89    86    77    122   113   111   159   144   
     63    89    86    77    122   113   111   159   144   
     63    89    86    77    122   113   111   159   144   
     63    89    86    77    122   113   111   159   144   

A2   106   200   155   95    166   141   114   163   147   
     106   200   155   95    166   141   114   164   148   
     106   200   155   95    167   142   115   164   148   
     107   201   155   95    167   142   115   165   149   

bg   63    89    86    77    122   113   111   159   144   
     63    89    86    77    122   113   111   159   144   
     63    89    86    77    122   113   111   159   144   
     63    89    86    77    122   113   111   159   144   

A3   70    143   166   81    147   145   112   162   148   
     70    143   167   81    147   145   112   162   148   
     70    143   166   81    147   145   112   162   148   
     70    142   166   81    147   145   112   162   148   

bg   63    89    86    77    122   113   111   159   144   
     63    89    86    77    122   113   111   159   144   
     63    89    86    77    122   113   111   159   144   
     63    89    86    77    122   113   111   159   144   

B1   94    116   93    151   187   129   145   188   152   
     94    116   93    151   187   129   145   188   152   
     94    116   93    151   187   129   145   189   152   
     94    116   93    151   186   129   145   188   152   

bg   63    88    85    77    121   112   110   158   143   
     63    89    86    77    122   113   110   158   144   
     63    89    86    77    122   113   110   158   144   
     63    89    86    77    122   113   110   158   143   

B2   81    130   112   116   232   179   131   200   170   
     81    130   112   116   231   179   131   200   170   
     81    130   113   117   232   180   131   201   171   
     81    130   113   117   232   180   132   202   172   

bg   63    89    85    77    122   112   110   158   143   
     63    89    85    77    122   112   111   158   143   
     63    88    85    76    121   111   110   157   142   
     63    88    85    76    121   111   110   157   142   

B3   68    110   115   84    175   191   117   186   181   
     66    107   113   82    172   189   115   182   177   
     66    108   113   82    172   189   115   182   177   
     66    108   113   82    172   189   115   182   177   

bg   63    89    86    77    122   112   111   159   144   
     63    89    86    77    122   112   111   159   143   
     63    89    86    77    122   113   111   159   144   
     63    89    86    77    122   112   111   159   143   

C1   67    93    88    110   155   124   191   230   166   
     67    92    87    110   155   124   191   230   165   
     67    92    87    110   154   123   190   228   164   
     67    93    87    110   155   124   190   229   165   

bg   64    90    86    78    124   114   112   160   145   
     64    90    87    78    124   114   112   161   146   
     64    90    86    78    123   114   112   160   145   
     63    89    86    77    123   113   111   159   144   

C2   66    93    88    98    171   145   163   269   210   
     66    93    88    98    170   144   162   268   210   
     66    93    88    98    170   144   163   268   210   
     66    94    89    99    172   145   164   269   211   

bg   63    88    85    77    121   112   110   158   143   
     63    88    85    77    122   112   110   158   143   
     63    88    85    77    121   112   110   158   143   
     63    89    85    77    122   112   110   158   143   

C3   64    91    88    80    144   143   118   207   215   
     64    91    88    80    144   143   118   206   214   
     64    91    88    80    144   143   118   207   214   
     64    91    88    80    144   143   118   207   215   

bg   63    89    85    77    122   112   110   158   143   
     63    88    85    77    121   112   110   158   143   
     63    88    85    76    121   112   110   157   142   
     63    88    85    76    121   112   110   157   142   
