     A1    A2    A3    B1    B2    B3    C1    C2    C3    

A1   132   148   99    103   146   119   114   162   146   
     132   149   100   103   146   120   115   162   146   
     133   150   101   104   148   121   116   164   148   
     133   151   101   105   149   122   117   166   150   

bg   63    89    85    77    122   113   110   158   143   
     63    89    86    77    122   113   110   158   144   
     63    89    85    77    122   112   110   158   143   
     63    88    85    76    121   112   110   157   143   

A2   107   201   156   96    168   142   115   165   149   
     107   201   156   96    168   143   116   165   150   
     106   200   155   95    167   142   115   164   148   
     106   201   155   95    167   142   115   164   148   

bg   64    89    86    77    123   113   111   159   145   
     64    89    86    77    123   113   111   159   145   
     64    90    86    77    123   114   111   160   145   
     64    90    87    78    124   114   112   160   146   

A3   70    142   166   81    146   145   112   161   148   
     71    143   167   81    147   146   113   163   149   
     70    143   166   81    147   145   112   162   148   
     70    142   166   80    146   144   112   161   148   

bg   63    89    86    77    122   113   110   158   144   
     63    89    86    77    122   113   111   159   144   
     63    89    86    77    122   113   111   159   144   
     63    89    86    77    122   113   110   158   144   

B1   94    116   93    151   187   130   146   189   152   
     94    117   94    151   188   130   146   189   153   
     95    118   95    153   189   132   148   192   155   
     96    119   96    153   191   133   149   194   157   

bg   63    89    86    77    122   113   111   159   144   
     63    89    86    77    122   113   111   159   144   
     63    89    86    77    123   113   111   159   144   
     63    89    86    77    123   113   111   159   144   

B2   81    130   112   117   232   180   131   201   171   
     81    130   113   117   232   180   131   201   171   
     81    130   112   117   232   180   131   201   171   
     81    130   112   116   231   179   131   201   171   

bg   63    89    86    77    122   113   111   159   144   
     63    89    86    77    122   113   111   159   144   
     63    89    86    77    122   113   111   159   144   
     63    89    86    77    122   113   111   159   144   

B3   66    108   113   82    172   189   115   182   178   
     66    108   113   82    172   189   115   182   178   
     66    108   113   82    172   189   115   182   178   
     66    108   113   82    172   189   115   182   178   

bg   63    89    86    77    122   113   110   158   144   
     63    88    85    76    121   112   110   157   143   
     63    88    85    76    121   112   110   157   143   
     63    89    86    77    122   113   110   158   144   

C1   67    92    88    110   155   124   191   230   166   
     67    93    88    110   155   124   191   230   166   
     67    93    88    110   155   124   191   230   166   
     67    92    87    110   154   124   190   229   165   

bg   63    89    86    77    122   113   111   159   144   
     63    89    86    77    122   113   111   159   144   
     63    89    86    77    122   113   111   159   144   
     63    89    86    77    122   113   111   159   144   

C2   66    94    89    99    172   146   164   270   212   
     66    93    89    98    171   145   163   269   211   
     66    94    89    99    171   146   163   269   211   
     66    93    89    98    171   145   163   268   211   

bg   64    90    86    78    123   114   111   160   145   
     63    89    86    77    123   113   111   159   144   
     63    89    86    77    122   113   111   159   144   
     63    89    85    77    122   112   110   158   143   

C3   65    91    89    80    145   144   118   207   216   
     65    92    89    81    145   144   119   208   216   
     65    92    89    81    145   144   119   208   216   
     65    91    89    80    145   144   119   208   216   

bg   63    89    86    77    122   113   111   159   144   
     63    89    86    77    122   113   111   159   144   
     63    89    85    77    122   112   110   158   143   
     63    89    86    77    122   113   111   158   144   
