     A1    A2    A3    B1    B2    B3    C1    C2    C3    

A1   128   145   100   102   146   121   116   163   148   
     128   145   100   102   146   122   116   164   149   
     127   145   100   102   146   122   116   164   149   
     127   145   100   101   145   121   115   163   148   

bg   64    90    87    78    123   115   111   160   146   
     64    90    87    78    123   115   112   160   146   
     64    90    87    78    124   115   112   160   146   
     64    90    87    78    123   115   112   160   146   

A2   107   202   157   97    169   144   116   167   151   
     107   202   157   96    169   144   116   167   151   
     107   202   157   96    168   144   116   166   151   
     107   202   157   96    169   144   116   166   151   

bg   64    90    87    78    123   115   111   160   146   
     64    90    87    77    123   115   111   160   146   
     64    90    87    78    123   114   111   160   146   
     64    90    87    78    124   115   112   160   146   

A3   71    144   168   82    148   147   114   164   151   
     71    144   168   82    149   147   114   164   151   
     71    144   168   81    148   146   113   163   150   
     71    143   168   82    148   147   113   163   150   

bg   64    90    86    78    124   114   112   160   145   
     64    90    87    78    124   114   112   161   146   
     65    91    88    79    126   116   114   163   148   
     65    92    89    80    126   117   115   164   149   

B1   96    118   95    153   190   133   148   192   156   
     98    121   98    156   194   137   152   198   161   
     97    121   98    156   195   137   152   198   161   
     95    118   96    153   191   133   148   193   157   

bg   64    90    87    78    123   114   111   160   146   
     64    90    87    78    123   114   112   160   146   
     64    90    87    78    123   115   112   160   146   
     64    90    87    78    124   115   112   160   146   

B2   81    131   113   117   233   181   132   202   173   
     82    131   114   117   234   181   132   203   173   
     82    131   114   117   233   181   132   202   173   
     82    131   114   117   233   181   132   202   173   

bg   64    90    87    78    123   114   112   160   145   
     64    90    87    78    124   115   112   161   146   
     64    91    88    79    125   116   113   162   148   
     64    90    87    78    124   115   112   160   146   

B3   67    109   114   83    173   191   116   184   180   
     67    108   114   83    173   191   116   184   179   
     67    108   114   82    173   191   116   184   180   
     67    109   114   83    173   191   116   184   179   

bg   64    90    87    78    124   115   112   161   146   
     64    90    87    78    124   115   112   161   147   
     65    92    89    80    126   117   114   164   149   
     65    91    88    79    126   117   114   163   148   

C1   71    99    94    116   163   132   198   241   176   
     69    95    91    112   158   128   194   235   170   
     68    94    89    111   156   126   192   232   168   
     68    93    89    111   156   126   191   231   168   

bg   64    90    87    78    123   114   112   160   146   
     64    90    87    78    123   114   111   160   146   
     64    90    87    78    123   114   112   160   146   
     64    90    87    78    124   115   112   161   146   

C2   66    94    90    99    172   146   164   270   213   
     66    94    90    99    172   147   164   270   213   
     66    94    89    99    171   146   163   269   212   
     67    94    90    99    172   147   164   269   212   

bg   64    90    87    78    124   114   112   160   146   
     64    90    87    78    124   115   112   161   146   
     64    90    87    78    123   114   112   160   146   
     64    90    87    78    123   114   111   160   145   

C3   65    92    89    80    145   145   118   208   216   
     65    92    90    81    145   145   119   208   217   
     65    93    90    81    147   146   120   210   218   
     65    92    90    81    146   146   120   209   218   

bg   64    90    87    78    124   115   112   161   146   
     64    90    87    78    123   114   112   160   146   
     64    90    87    78    123   114   111   160   145   
     64    89    86    77    123   114   111   159   145   
