     A1    A2    A3    B1    B2    B3    C1    C2    C3    

A1   136   152   101   105   149   121   117   166   148   
     136   152   101   105   149   120   117   166   147   
     136   152   101   105   149   121   117   166   148   
     136   152   101   105   149   121   117   166   148   

bg   66    92    88    79    126   114   114   163   146   
     66    92    88    80    126   115   114   164   147   
     66    92    88    80    126   115   114   164   147   
     66    92    88    80    126   115   114   164   147   

A2   109   204   157   98    170   143   117   169   150   
     109   204   157   98    171   143   118   169   150   
     109   204   157   98    171   143   118   169   151   
     109   204   157   98    171   143   118   169   151   

bg   66    92    88    80    126   115   114   164   147   
     66    92    88    80    127   115   114   164   147   
     66    92    88    80    126   115   114   164   147   
     66    92    88    80    126   115   114   164   147   

A3   73    145   168   83    150   146   115   167   150   
     73    146   169   83    151   147   115   167   151   
     73    146   169   83    151   147   115   167   151   
     74    146   170   84    152   148   116   168   152   

bg   66    92    88    80    127   115   114   164   147   
     66    92    88    80    127   115   114   164   147   
     66    92    88    80    127   115   114   164   147   
     66    92    88    80    127   115   114   164   147   

B1   97    120   96    154   192   132   149   195   156   
     97    119   95    154   191   131   149   194   155   
     97    119   95    154   191   131   149   194   155   
     97    119   95    153   191   131   149   194   155   

bg   67    94    90    81    129   117   116   167   150   
     67    93    89    80    127   115   115   165   148   
     67    93    88    80    127   115   114   165   147   
     66    92    88    79    126   115   114   163   146   

B2   84    133   115   119   236   181   134   206   173   
     84    133   115   119   236   181   134   206   173   
     84    134   116   120   236   182   135   207   175   
     85    134   116   120   236   182   136   208   175   

bg   66    92    88    79    126   114   113   163   146   
     65    91    87    79    124   113   112   161   144   
     65    91    87    79    125   113   112   162   145   
     66    92    88    79    126   114   113   163   146   

B3   70    112   117   85    177   193   120   189   182   
     71    113   118   87    179   195   121   192   184   
     76    121   125   93    190   203   130   204   196   
     75    120   125   93    189   203   130   204   196   

bg   66    92    88    80    126   115   114   164   147   
     66    92    88    80    126   115   114   164   147   
     66    92    88    79    126   115   114   163   147   
     66    92    88    80    127   115   114   164   148   

C1   70    96    90    112   159   126   193   234   168   
     70    96    90    112   159   126   193   234   168   
     70    95    90    112   158   126   193   234   167   
     72    99    93    115   163   130   197   239   173   

bg   66    92    88    79    125   114   113   163   146   
     67    93    89    80    127   115   114   164   147   
     67    94    90    81    128   117   116   167   149   
     67    93    89    80    128   116   115   166   148   

C2   70    99    93    102   175   148   168   273   214   
     75    103   99    106   184   155   173   280   221   
     68    95    90    99    171   144   162   266   208   
     69    96    91    100   172   145   163   267   210   

bg   66    92    88    80    127   115   114   164   147   
     66    92    88    80    126   115   114   164   147   
     66    92    88    80    126   115   114   164   147   
     66    92    88    80    126   115   114   164   147   

C3   66    92    89    81    147   145   119   211   219   
     65    92    88    80    146   144   118   210   217   
     65    91    88    80    146   144   118   210   217   
     66    93    90    82    148   146   120   212   220   

bg   66    92    88    80    127   115   114   164   147   
     66    92    88    80    126   115   114   164   147   
     66    92    88    80    126   115   114   164   147   
     66    92    88    80    126   115   114   164   147   
