     A1    A2    A3    B1    B2    B3    C1    C2    C3    

A1   137   154   102   107   152   122   119   169   150   
     137   154   103   107   152   123   120   170   150   
     135   151   103   107   151   123   120   170   151   
     138   154   103   107   152   123   120   170   151   

bg   69    95    91    82    131   119   118   170   152   
     68    94    90    82    130   118   117   168   150   
     67    94    89    81    129   117   116   167   149   
     67    94    89    81    128   116   116   166   149   

A2   110   204   157   98    172   144   119   171   152   
     110   205   158   99    172   144   119   171   152   
     110   205   158   98    172   144   119   170   151   
     110   204   157   98    172   144   119   170   151   

bg   68    94    90    81    129   117   116   167   149   
     68    94    90    81    129   117   117   167   150   
     68    94    90    82    129   117   117   168   150   
     69    96    91    83    131   119   118   170   152   

A3   74    147   170   84    152   148   117   169   152   
     74    147   170   84    153   148   117   169   152   
     74    147   170   85    153   148   117   169   153   
     74    147   170   84    153   148   117   169   152   

bg   68    94    90    82    129   117   117   168   150   
     67    94    89    81    128   116   116   166   149   
     67    94    89    81    128   116   116   166   148   
     67    93    89    81    128   116   115   166   148   

B1   98    121   97    155   194   133   151   197   157   
     98    121   96    155   193   133   150   197   157   
     98    121   96    155   193   132   150   196   156   
     98    121   96    155   193   132   150   196   156   

bg   67    93    89    81    128   116   116   166   148   
     67    93    88    80    127   115   115   165   147   
     67    93    89    80    127   115   115   165   147   
     67    94    89    81    129   116   116   167   149   

B2   85    135   116   121   239   183   137   209   176   
     86    136   117   122   240   185   138   212   178   
     86    136   117   122   240   185   138   211   178   
     85    135   116   121   239   183   137   210   177   

bg   67    93    89    80    127   115   115   165   147   
     67    93    88    80    127   115   115   165   147   
     66    92    88    80    127   115   114   164   147   
     68    95    91    82    130   118   117   168   150   

B3   70    112   117   86    178   193   121   191   183   
     70    112   116   86    178   193   120   190   182   
     70    112   117   86    178   193   120   191   183   
     70    112   117   86    178   193   120   190   182   

bg   67    94    89    81    128   116   116   166   149   
     68    94    90    81    129   117   116   167   149   
     67    93    89    80    128   116   115   166   148   
     67    93    89    80    128   116   115   165   148   

C1   71    97    91    114   160   128   195   237   171   
     71    97    91    113   160   127   195   237   170   
     71    97    91    113   160   127   195   236   170   
     71    97    91    113   160   127   195   237   170   

bg   68    94    90    82    129   117   117   168   150   
     69    96    91    83    132   119   119   171   153   
     68    95    90    82    130   118   117   169   151   
     67    94    89    81    128   116   116   166   149   

C2   71    99    93    102   177   149   168   275   215   
     70    99    93    102   176   148   167   274   215   
     71    99    93    102   176   148   167   274   214   
     73    102   96    104   180   152   170   278   219   

bg   68    94    89    81    129   117   116   167   150   
     67    94    89    81    128   116   116   167   149   
     67    94    89    81    128   116   116   166   149   
     68    94    91    82    129   117   117   168   151   

C3   68    96    92    84    152   149   124   217   224   
     69    96    92    84    152   149   124   218   225   
     69    96    92    84    152   149   124   218   225   
     69    97    93    85    153   150   125   219   226   

bg   67    93    89    81    128   116   116   166   149   
     68    95    90    82    130   118   117   168   151   
     69    96    92    83    132   120   119   171   153   
     68    95    90    82    130   118   117   169   151   
