     A1    A2    A3    B1    B2    B3    C1    C2    C3    

A1   138   155   104   108   154   124   121   172   153   
     137   154   102   107   152   123   120   170   151   
     137   153   102   106   151   122   119   168   150   
     136   153   102   106   150   121   118   168   149   

bg   67    93    89    80    128   116   115   165   148   
     67    93    88    80    127   115   115   165   147   
     67    93    88    80    127   115   115   165   147   
     67    93    88    80    127   115   115   165   147   

A2   110   205   158   98    172   144   119   170   151   
     110   205   158   98    172   144   119   171   152   
     110   205   158   98    172   144   119   171   152   
     110   205   158   98    172   144   119   171   152   

bg   67    93    89    81    128   116   116   166   148   
     68    94    90    81    129   117   116   167   149   
     68    95    90    82    130   118   117   168   150   
     67    94    89    81    129   116   116   167   149   

A3   77    152   174   88    158   153   122   177   159   
     74    147   170   84    153   148   117   169   152   
     74    147   169   84    152   148   117   169   152   
     74    147   170   84    153   148   117   169   152   

bg   67    93    89    81    128   116   115   166   148   
     67    93    89    81    128   116   115   166   148   
     67    93    89    81    128   116   115   166   148   
     68    94    89    81    129   117   116   167   149   

B1   98    120   96    155   193   132   150   196   156   
     98    120   96    155   193   132   150   196   156   
     98    121   96    155   193   133   150   197   157   
     97    120   96    154   192   132   150   195   156   

bg   67    93    89    80    127   115   115   166   148   
     67    93    89    81    128   116   115   166   148   
     67    93    89    81    128   116   115   166   148   
     67    93    89    80    128   116   115   165   148   

B2   85    135   116   121   239   183   136   209   175   
     85    135   116   121   239   184   137   210   176   
     85    135   116   120   238   183   136   209   176   
     85    135   116   120   238   183   136   209   176   

bg   66    93    88    80    127   115   114   164   147   
     67    93    89    80    128   116   115   165   148   
     67    93    89    81    128   116   115   166   148   
     67    93    89    81    128   116   115   166   148   

B3   69    111   115   84    176   191   118   187   180   
     69    111   116   85    177   192   119   188   181   
     70    112   117   86    178   193   120   190   183   
     70    112   116   85    178   192   120   189   182   

bg   67    93    89    80    128   116   115   165   148   
     67    93    89    81    128   116   115   166   149   
     68    95    90    82    130   118   117   169   151   
     69    97    92    83    132   120   119   171   153   

C1   71    97    91    113   160   127   195   236   170   
     71    97    91    113   160   127   195   236   170   
     71    97    91    113   160   127   195   236   170   
     71    97    91    113   160   127   194   236   170   

bg   67    93    89    81    128   116   115   166   148   
     67    93    88    80    127   115   115   165   148   
     67    93    88    80    127   115   115   165   148   
     67    94    89    81    129   117   116   167   149   

C2   70    97    92    101   174   146   165   270   212   
     69    97    92    101   174   146   165   270   212   
     69    97    91    100   173   146   164   269   211   
     70    97    92    101   174   146   165   270   211   

bg   67    94    89    81    128   116   116   166   149   
     67    93    89    81    128   116   115   166   149   
     67    93    89    81    128   116   115   166   149   
     67    93    89    81    128   116   115   166   148   

C3   68    96    92    84    152   149   124   217   224   
     68    96    92    84    151   149   123   217   224   
     68    96    92    84    151   149   123   217   223   
     68    96    92    84    152   149   124   218   224   

bg   67    93    89    81    128   116   115   166   148   
     67    93    89    80    127   115   115   165   148   
     67    93    88    80    127   115   114   164   147   
     67    93    89    80    127   115   115   165   148   
