     A1    A2    A3    B1    B2    B3    C1    C2    C3    

A1   131   149   103   104   150   124   119   169   152   
     131   149   103   104   150   125   119   170   152   
     131   149   103   104   151   125   120   170   153   
     130   148   103   104   150   124   119   169   152   

bg   67    93    90    80    127   117   115   165   149   
     67    94    91    81    129   119   116   167   151   
     68    96    92    83    131   121   118   170   154   
     68    95    92    82    130   120   117   169   153   

A2   110   205   159   99    172   146   119   171   154   
     110   205   159   99    173   147   119   172   154   
     111   206   161   100   175   148   121   175   157   
     112   207   162   101   176   150   123   176   158   

bg   68    95    92    82    130   120   118   169   153   
     69    96    92    83    131   121   118   170   154   
     67    94    90    81    128   118   116   167   150   
     67    93    90    80    128   118   115   166   150   

A3   74    147   171   84    153   150   117   170   154   
     74    147   171   85    153   150   117   170   155   
     75    149   173   86    156   153   120   173   158   
     77    151   174   88    158   154   122   175   160   

bg   68    95    91    82    130   119   117   168   152   
     67    94    91    81    129   119   116   167   151   
     67    94    90    81    128   118   116   167   150   
     67    93    90    80    128   118   115   166   150   

B1   98    121   98    155   194   135   151   197   159   
     97    120   97    154   193   134   150   196   158   
     97    120   97    154   192   134   149   195   157   
     97    120   97    154   192   134   149   195   158   

bg   67    93    90    80    127   117   115   165   149   
     67    93    90    80    128   118   115   165   150   
     67    93    90    81    128   118   115   166   150   
     67    94    91    81    129   119   116   167   151   

B2   85    135   117   120   238   185   136   208   177   
     84    134   116   119   236   184   135   207   176   
     84    134   117   120   237   184   136   207   176   
     84    133   116   120   234   184   135   207   176   

bg   67    94    90    81    128   118   116   166   150   
     67    94    90    81    128   118   116   166   150   
     67    94    90    81    128   118   116   166   150   
     67    94    90    81    128   118   116   166   150   

B3   71    113   119   87    180   196   121   192   186   
     70    113   119   86    179   196   121   192   185   
     70    113   119   86    179   195   121   191   185   
     70    113   119   86    179   196   121   191   185   

bg   67    94    90    81    128   118   116   166   150   
     67    93    90    80    128   118   115   166   150   
     67    93    90    80    128   117   115   165   149   
     68    95    91    82    130   120   117   168   152   

C1   71    97    93    113   160   129   194   236   172   
     71    97    93    113   161   130   194   237   172   
     71    98    93    114   161   130   195   237   172   
     71    97    93    113   161   130   195   237   172   

bg   67    93    90    80    127   118   115   165   149   
     67    94    90    81    128   118   116   166   150   
     68    94    91    81    129   119   117   167   151   
     68    95    92    82    130   120   118   169   153   

C2   70    98    94    102   176   150   167   275   217   
     70    98    93    102   176   150   167   274   216   
     70    98    93    102   176   150   167   274   216   
     70    98    93    101   176   150   167   273   215   

bg   67    93    90    81    128   118   115   166   150   
     67    93    90    80    128   118   115   166   150   
     67    93    90    81    128   118   115   166   150   
     67    93    90    81    128   118   116   166   150   

C3   68    96    93    84    151   150   123   217   225   
     68    96    93    84    152   151   124   217   225   
     68    96    94    84    152   151   124   218   226   
     68    96    94    85    153   152   124   218   226   

bg   67    94    90    81    128   118   116   166   150   
     67    94    91    81    128   118   116   166   151   
     67    94    90    81    128   118   116   166   150   
     67    94    90    81    128   118   116   166   150   
