     A1    A2    A3    B1    B2    B3    C1    C2    C3    

A1   127   145   102   102   149   123   118   168   151   
     126   144   101   102   148   123   118   168   150   
     126   144   101   102   148   123   118   168   151   
     126   145   102   102   149   124   119   169   151   

bg   68    95    91    82    130   119   117   168   152   
     67    94    90    81    129   118   116   167   150   
     67    94    90    81    128   118   116   166   150   
     67    93    90    80    127   117   115   165   149   

A2   109   203   158   98    171   146   119   170   153   
     109   203   158   98    171   145   118   170   153   
     109   203   158   98    171   146   119   171   153   
     110   204   159   99    173   147   120   172   155   

bg   67    93    90    80    128   118   115   165   150   
     67    93    90    80    127   117   115   165   149   
     67    93    90    80    128   118   115   165   150   
     67    93    90    81    128   118   115   166   150   

A3   74    147   170   85    153   150   118   170   155   
     75    149   172   86    156   152   120   173   158   
     74    147   170   85    153   150   118   170   155   
     74    146   169   84    152   149   117   169   154   

bg   67    93    90    80    128   118   115   165   150   
     67    93    90    80    127   117   115   165   149   
     67    93    90    80    128   118   115   166   150   
     67    93    90    81    128   118   115   166   150   

B1   97    120   97    154   192   134   150   196   158   
     97    121   98    154   192   135   150   196   158   
     97    120   97    153   192   134   149   195   158   
     97    120   97    153   192   134   149   195   158   

bg   67    94    90    81    128   118   116   166   150   
     67    94    90    81    128   118   116   166   150   
     67    93    90    81    128   118   115   166   150   
     67    93    90    81    128   118   115   166   150   

B2   85    134   117   120   235   183   136   208   177   
     84    134   117   119   235   183   136   207   177   
     84    134   116   119   233   182   136   207   176   
     84    134   116   119   233   182   135   207   176   

bg   67    94    91    81    129   119   116   167   151   
     67    93    90    81    128   118   116   166   150   
     67    94    90    81    128   118   116   166   150   
     67    94    91    81    128   118   116   166   151   

B3   70    112   118   85    178   194   120   190   184   
     70    112   118   86    178   194   120   190   184   
     70    112   118   86    178   194   120   190   184   
     70    113   119   86    179   195   121   191   185   

bg   67    93    90    81    128   118   115   166   150   
     67    93    90    80    127   118   115   165   149   
     67    93    90    80    128   118   115   165   150   
     67    94    90    81    128   118   116   166   150   

C1   70    97    92    113   160   129   193   235   171   
     71    97    93    113   160   130   194   236   172   
     71    98    93    114   161   130   194   237   172   
     71    97    93    113   161   130   194   236   172   

bg   67    94    91    81    129   119   116   167   151   
     67    93    90    80    128   118   115   165   150   
     67    94    90    81    128   118   116   166   150   
     67    94    91    81    129   119   116   167   151   

C2   70    98    94    102   176   150   167   273   216   
     70    98    94    102   176   150   167   273   216   
     70    98    94    102   176   150   167   273   216   
     70    98    94    102   176   150   167   273   216   

bg   76    107   103   92    147   135   132   190   172   
     69    97    95    83    133   122   120   172   155   
     68    94    91    82    130   119   117   168   152   
     68    95    92    82    130   120   117   168   152   

C3   69    97    94    85    153   152   125   219   227   
     69    97    94    85    153   152   125   219   227   
     69    97    94    85    153   152   124   218   226   
     68    96    93    84    152   151   123   217   225   

bg   67    94    91    81    129   119   116   167   151   
     67    94    91    81    129   119   116   167   151   
     67    94    91    81    129   119   116   167   151   
     67    94    91    81    129   119   116   167   151   
