     A1    A2    A3    B1    B2    B3    C1    C2    C3    

A1   413   569   399   399   591   420   373   506   371   
     413   569   399   398   591   420   373   505   371   
     412   568   400   398   591   420   372   505   371   
     413   569   399   398   591   419   373   505   371   

bg   343   508   386   372   567   413   369   503   369   
     343   509   386   372   567   413   369   502   370   
     343   509   385   372   567   413   369   503   369   
     344   509   385   373   567   413   369   503   369   

A2   386   619   454   390   611   441   373   507   372   
     386   619   454   390   611   441   373   507   372   
     386   619   454   390   611   441   372   507   373   
     385   619   454   390   611   442   372   507   373   

bg   343   508   386   372   567   415   368   502   371   
     343   508   386   372   567   415   369   502   371   
     344   508   386   372   567   414   369   503   371   
     343   509   386   372   567   414   369   503   371   

A3   350   562   466   376   592   446   371   506   375   
     350   562   466   376   592   446   370   506   376   
     350   562   467   376   592   446   370   506   375   
     350   562   466   376   592   446   371   506   375   

bg   343   508   386   372   567   415   369   502   371   
     343   508   386   372   567   414   369   502   371   
     343   508   386   372   567   414   369   502   371   
     343   508   386   372   567   414   369   502   371   

B1   374   535   393   446   632   430   404   532   379   
     374   535   393   446   631   431   403   532   379   
     374   535   393   445   631   431   403   532   379   
     374   535   393   445   631   431   403   532   379   

bg   343   508   386   372   567   415   368   502   371   
     343   508   386   372   567   414   369   502   371   
     344   508   386   372   567   414   369   502   371   
     343   508   386   372   567   414   369   502   371   

B2   361   550   412   412   678   481   390   545   398   
     361   550   413   412   677   481   390   545   398   
     361   549   413   412   677   482   389   544   398   
     361   549   413   411   676   481   389   544   398   

bg   343   508   386   372   567   414   369   502   371   
     343   508   386   372   567   414   369   502   371   
     343   508   386   372   567   414   369   502   371   
     344   508   386   372   567   414   369   502   371   

B3   346   527   413   377   617   491   373   526   404   
     346   527   413   377   617   490   373   526   404   
     346   527   413   377   617   491   373   526   405   
     346   527   413   376   617   491   373   526   405   

bg   343   509   386   372   567   415   369   503   371   
     343   508   386   372   567   415   369   502   371   
     343   508   386   372   567   415   369   503   371   
     344   508   386   372   567   414   369   503   371   

C1   347   512   388   405   600   426   449   573   393   
     347   512   388   405   600   426   448   573   393   
     347   512   388   405   600   426   448   573   393   
     347   512   388   405   600   426   449   573   393   

bg   343   509   386   372   567   415   369   503   371   
     344   509   386   372   567   414   369   503   371   
     344   509   386   373   567   415   369   503   371   
     343   509   386   372   567   415   369   503   371   

C2   346   513   389   394   616   447   422   613   439   
     346   513   389   394   616   447   421   613   439   
     346   513   390   394   616   447   421   612   439   
     346   513   389   394   616   447   421   612   438   

bg   343   509   386   372   567   415   369   503   372   
     344   509   386   372   568   415   369   503   371   
     344   509   386   373   567   415   369   503   371   
     343   509   386   372   567   415   369   503   371   

C3   345   511   389   376   590   446   377   552   443   
     345   511   389   376   590   446   377   552   443   
     345   511   389   376   590   446   377   552   444   
     345   511   389   376   590   446   377   552   443   

bg   343   508   386   372   567   415   369   503   371   
     344   508   386   373   567   414   369   503   371   
     344   508   386   372   567   414   369   503   371   
     343   508   386   372   567   415   369   502   371   
