     A1    A2    A3    B1    B2    B3    C1    C2    C3    

A1   413   569   400   398   591   421   373   506   373   
     413   569   400   399   591   421   373   506   373   
     413   569   399   399   591   421   373   506   373   
     413   569   400   399   591   421   373   506   373   

bg   343   508   386   372   568   414   369   503   371   
     343   509   386   372   568   415   369   503   371   
     343   508   386   372   568   415   369   503   371   
     344   509   386   373   567   414   369   503   371   

A2   386   619   454   390   611   442   373   507   374   
     386   619   454   390   611   443   372   507   375   
     386   619   454   390   611   443   372   507   375   
     386   619   454   390   611   443   372   507   375   

bg   343   508   386   372   567   414   369   503   371   
     344   508   386   373   567   414   369   502   371   
     343   509   386   372   567   414   369   503   371   
     343   508   386   372   567   414   369   503   371   

A3   350   562   466   376   592   446   371   506   375   
     350   562   466   376   592   447   371   506   376   
     351   562   466   376   592   446   371   506   375   
     351   562   466   376   592   446   371   506   375   

bg   344   509   386   373   567   414   369   503   371   
     343   508   386   372   567   415   369   503   371   
     343   508   386   372   567   415   369   503   371   
     343   508   386   372   567   414   369   503   371   

B1   374   535   393   446   632   431   404   532   379   
     374   536   393   446   632   431   404   532   379   
     374   536   393   446   632   431   404   532   379   
     374   535   393   446   632   431   404   532   379   

bg   344   509   386   373   568   414   369   503   371   
     343   508   386   372   567   414   369   503   371   
     343   509   386   372   567   415   369   503   371   
     343   508   386   372   567   415   369   503   371   

B2   361   550   413   412   678   482   390   545   399   
     361   550   413   412   677   481   390   545   399   
     361   550   413   412   677   481   390   545   398   
     361   550   413   412   677   481   390   545   399   

bg   343   508   386   372   567   415   369   503   371   
     343   508   386   372   568   415   369   503   371   
     344   509   386   373   568   414   370   503   371   
     344   509   386   373   568   414   370   503   371   

B3   346   527   413   377   617   490   374   526   404   
     346   527   413   377   617   491   373   526   405   
     346   527   413   377   617   491   374   526   405   
     346   527   413   377   617   490   374   526   405   

bg   343   509   386   373   567   414   369   503   371   
     344   508   386   373   568   415   369   503   371   
     343   509   386   373   568   414   369   503   371   
     343   508   386   372   567   414   369   503   371   

C1   347   512   388   405   600   426   449   573   393   
     347   512   388   405   600   425   449   573   393   
     347   512   388   405   600   426   449   573   392   
     347   512   387   405   600   426   449   573   393   

bg   343   508   386   372   567   414   369   503   371   
     343   508   386   372   567   414   369   502   371   
     343   508   386   372   567   414   369   503   371   
     343   508   386   372   567   414   369   502   371   

C2   346   513   389   393   616   447   422   613   438   
     346   513   389   394   616   447   422   612   438   
     346   513   389   394   616   447   422   612   438   
     346   513   389   394   616   447   421   612   438   

bg   343   508   386   372   567   414   369   502   371   
     343   508   386   372   567   414   369   503   371   
     343   508   386   372   567   415   369   502   371   
     343   508   386   372   567   414   369   503   371   

C3   345   511   390   376   590   447   377   552   445   
     345   511   389   376   590   447   377   552   445   
     345   511   390   376   590   447   377   552   445   
     345   511   390   376   590   447   377   552   445   

bg   344   509   387   372   568   416   369   503   373   
     344   508   387   373   568   416   369   503   373   
     344   509   387   373   568   416   370   503   373   
     344   508   387   373   568   416   370   503   373   
