     A1    A2    A3    B1    B2    B3    C1    C2    C3    

A1   414   569   401   399   592   422   373   506   374   
     414   569   401   399   592   422   373   506   374   
     414   569   400   399   591   422   373   506   374   
     414   569   400   399   591   422   373   506   374   

bg   344   509   387   373   568   416   369   503   373   
     344   509   387   373   568   416   369   503   373   
     344   509   386   372   568   416   369   503   373   
     344   509   387   372   568   416   369   503   373   

A2   386   619   455   390   612   444   373   507   376   
     387   619   455   391   611   444   373   507   376   
     386   619   455   390   611   444   373   507   376   
     386   619   455   390   612   444   373   507   376   

bg   344   509   387   373   568   416   369   503   373   
     344   509   387   373   568   416   369   503   373   
     344   509   387   373   568   416   369   503   373   
     344   509   387   373   568   416   369   503   373   

A3   351   562   467   376   593   448   371   506   377   
     351   562   467   377   593   448   371   506   377   
     351   562   467   376   592   448   371   506   377   
     351   562   467   376   592   448   371   506   377   

bg   344   509   387   373   568   416   369   503   373   
     344   509   387   373   568   416   369   503   373   
     344   509   387   373   568   416   369   503   373   
     344   509   386   373   568   416   369   503   373   

B1   374   536   394   447   633   432   404   533   381   
     374   536   394   446   632   432   404   533   381   
     374   536   394   446   632   432   404   532   381   
     374   536   394   446   632   432   404   533   381   

bg   344   509   386   373   568   416   369   503   373   
     344   509   387   373   568   416   369   503   373   
     344   509   387   372   568   416   369   503   373   
     344   509   387   373   568   416   370   503   373   

B2   361   550   413   412   678   483   390   545   400   
     361   550   413   412   677   483   390   545   400   
     361   550   413   412   677   482   390   545   400   
     361   550   413   412   677   482   390   545   400   

bg   344   509   387   373   568   416   369   503   373   
     344   508   386   372   567   416   369   503   373   
     344   509   387   372   568   416   369   503   373   
     344   509   386   373   568   416   369   503   373   

B3   346   527   414   377   617   492   374   526   406   
     346   527   414   377   617   492   373   526   406   
     346   527   414   377   617   492   373   526   406   
     346   527   414   377   617   492   374   526   406   

bg   344   509   386   372   568   416   369   503   373   
     344   509   386   373   568   416   369   503   373   
     344   509   387   373   568   416   369   503   373   
     344   509   386   373   568   416   369   503   373   

C1   347   512   388   405   600   427   449   573   394   
     347   512   389   406   600   427   449   573   394   
     347   512   388   406   600   427   449   574   394   
     347   512   388   406   600   427   449   573   394   

bg   344   509   387   373   568   416   369   503   373   
     344   509   387   373   568   416   369   503   373   
     344   509   387   373   568   416   369   503   373   
     344   509   387   373   568   416   369   503   373   

C2   346   513   390   394   617   449   422   613   440   
     346   513   390   394   617   449   422   613   440   
     346   513   390   394   616   449   422   612   440   
     346   513   390   394   617   448   422   612   440   

bg   344   509   386   373   568   416   369   503   373   
     344   509   387   373   567   416   369   503   373   
     344   509   387   373   568   416   369   503   373   
     344   509   386   373   568   416   369   503   373   

C3   345   511   389   376   590   447   377   552   445   
     345   511   389   376   590   447   377   552   445   
     345   511   390   376   590   447   377   551   444   
     345   511   389   376   590   447   377   552   445   

bg   344   508   386   373   568   416   369   503   373   
     344   509   386   372   567   416   369   503   373   
     344   508   386   373   568   416   369   503   373   
     344   508   386   372   568   416   369   503   373   
