     A1    A2    A3    B1    B2    B3    C1    C2    C3    

A1   414   569   400   399   591   422   373   506   374   
     414   569   400   399   591   422   373   506   374   
     414   569   400   399   591   422   373   506   374   
     413   569   400   399   591   422   373   505   374   

bg   344   508   386   372   567   415   369   503   372   
     343   508   386   372   567   415   369   503   372   
     343   508   386   372   567   415   369   503   372   
     343   508   386   372   567   415   369   503   372   

A2   386   619   454   390   611   443   372   507   376   
     386   619   454   390   611   443   373   507   376   
     386   619   454   390   611   443   372   507   376   
     386   618   454   390   611   443   373   507   376   

bg   343   508   386   372   567   415   369   503   372   
     343   508   386   372   567   415   369   503   372   
     343   508   386   372   567   415   369   502   372   
     343   508   386   372   567   415   369   503   372   

A3   350   561   466   376   592   447   371   506   377   
     350   562   466   376   592   447   371   506   377   
     350   562   466   376   592   447   371   506   376   
     350   562   466   376   592   447   371   506   376   

bg   343   508   386   372   567   415   369   502   372   
     343   508   386   372   567   415   369   502   372   
     343   508   386   372   567   415   369   502   372   
     343   508   386   372   567   415   369   502   372   

B1   374   535   393   446   632   431   404   533   380   
     374   535   393   446   632   432   404   532   380   
     374   535   393   446   632   431   404   532   380   
     374   535   393   446   631   431   404   532   380   

bg   343   508   386   372   567   415   369   502   372   
     343   508   386   372   567   415   369   503   372   
     343   508   386   372   567   415   369   503   372   
     343   508   386   372   567   415   369   503   372   

B2   361   549   413   412   677   482   390   545   399   
     361   549   413   412   677   482   390   545   399   
     361   549   413   412   676   482   390   545   399   
     361   549   413   412   676   482   390   545   399   

bg   343   508   386   372   567   415   369   503   372   
     343   508   386   372   567   415   369   503   372   
     343   508   386   372   567   415   369   503   372   
     343   508   386   372   567   415   369   503   372   

B3   346   526   413   377   616   491   373   526   406   
     346   526   413   377   617   491   373   526   406   
     346   527   413   377   617   491   373   526   406   
     346   526   413   377   617   491   373   526   406   

bg   343   508   386   372   567   415   369   503   372   
     343   508   386   372   567   415   369   502   372   
     343   508   386   372   567   415   369   502   372   
     343   508   386   372   567   415   369   502   372   

C1   347   511   388   405   599   426   449   573   394   
     347   511   388   405   599   426   449   573   394   
     347   511   388   405   599   427   449   573   394   
     347   511   388   405   600   426   449   573   394   

bg   343   508   386   372   567   415   369   503   372   
     343   508   386   372   567   415   369   503   372   
     343   508   386   372   567   415   369   502   372   
     343   508   386   372   567   415   369   502   372   

C2   346   512   389   394   616   448   422   613   439   
     346   512   389   394   616   448   422   612   439   
     346   512   389   394   616   448   421   612   439   
     346   512   389   394   616   448   421   611   439   

bg   343   508   386   372   567   415   369   503   372   
     343   508   386   372   567   415   369   503   372   
     343   508   386   372   567   415   369   503   372   
     343   508   386   372   567   415   369   503   372   

C3   344   510   389   376   590   447   377   552   444   
     345   510   389   376   589   446   377   552   444   
     345   510   389   376   590   446   377   552   444   
     344   510   389   376   590   447   377   552   445   

bg   343   508   386   372   567   415   369   503   372   
     343   508   386   372   567   415   369   502   372   
     343   508   386   372   567   415   369   502   372   
     343   508   386   372   567   415   369   503   372   
