Trial #5-------------------------

     A1    A2    A3    B1    B2    B3    C1    C2    C3    

A1   473   516   280   286   387   282   244   345   314   
     471   515   280   286   386   281   244   345   305   
     470   514   282   285   386   281   243   345   313   
     470   513   279   285   385   281   243   344   313   

bg   168   229   206   163   263   246   229   329   304   
     168   229   206   163   266   246   227   331   304   
     173   229   206   160   266   246   228   331   303   
     168   229   206   163   266   246   228   331   303   

A2   353   687   483   241   455   363   240   349   319   
     353   687   484   241   455   363   239   349   319   
     353   687   484   240   455   364   239   349   313   
     353   686   491   240   454   364   239   349   320   

bg   168   230   207   163   267   248   228   333   306   
     169   230   207   157   267   248   229   334   305   
     169   220   207   164   267   248   229   334   307   
     169   230   207   163   261   247   228   332   305   

A3   194   434   540   175   356   369   233   341   318   
     194   426   540   175   356   369   236   340   319   
     194   434   540   175   356   369   232   340   319   
     194   433   540   175   356   369   232   340   319   

bg   167   228   208   160   264   246   226   329   303   
     167   228   205   162   264   246   226   330   304   
     167   228   206   162   265   246   226   330   304   
     168   220   206   162   265   246   227   330   304   

B1   295   346   238   464   534   315   359   452   339   
     290   346   238   464   534   315   365   451   339   
     290   346   242   464   533   315   360   451   339   
     290   346   237   463   533   315   359   451   339   

bg   168   228   206   163   265   246   227   323   297   
     168   228   213   162   265   246   227   331   304   
     168   228   206   160   265   246   227   330   304   
     167   228   206   162   259   246   226   330   304   

B2   249   415   325   334   732   532   303   496   419   
     249   405   325   331   732   532   303   496   419   
     254   416   324   334   723   531   303   496   419   
     249   416   329   335   729   530   307   496   418   

bg   168   219   205   163   265   246   227   329   303   
     168   228   205   157   265   245   227   330   303   
     168   228   205   162   265   246   227   330   303   
     168   223   205   162   265   246   227   330   295   

B3   182   322   339   187   490   595   247   432   462   
     182   322   340   187   490   594   243   432   462   
     182   314   340   187   490   594   243   432   462   
     183   322   347   187   490   593   249   432   461   

bg   168   228   205   162   265   246   227   330   303   
     168   228   205   163   260   245   227   330   303   
     168   228   205   163   265   246   227   330   303   
     172   228   205   163   265   245   227   330   303   

C1   181   243   213   293   386   288   559   637   384   
     181   243   213   293   386   288   552   637   384   
     181   243   213   287   378   288   551   636   384   
     181   243   214   292   386   288   550   636   384   

bg   173   229   209   163   266   247   227   331   305   
     168   229   206   163   264   247   228   332   305   
     168   229   206   162   266   247   228   332   301   
     168   229   206   163   266   247   228   332   305   

C2   178   245   218   241   444   374   431   825   591   
     178   245   218   236   445   374   432   827   585   
     178   245   222   241   444   374   435   826   592   
     177   244   217   240   443   373   430   824   592   

bg   167   227   205   161   264   245   225   322   302   
     167   222   212   161   259   245   226   329   303   
     172   228   205   162   264   245   226   329   303   
     167   221   205   162   264   245   226   330   303   

C3   174   231   220   175   346   386   251   545   646   
     178   239   220   175   353   385   252   545   646   
     174   239   220   175   353   385   257   545   638   
     174   239   224   175   353   385   251   544   644   

bg   168   228   206   162   265   246   227   326   303   
     167   228   206   162   264   246   231   330   302   
     167   228   206   162   265   246   226   330   304   
     167   228   206   162   265   246   226   330   304   


Trial #6-------------------------

     A1    A2    A3    B1    B2    B3    C1    C2    C3    

A1   473   516   279   286   386   280   243   343   309   
     473   516   279   286   385   280   243   343   311   
     472   515   278   281   385   279   243   343   311   
     476   514   278   286   385   279   243   343   310   

bg   168   228   210   162   265   245   227   329   302   
     168   228   205   162   264   245   232   329   302   
     168   228   205   162   265   245   226   330   303   
     167   217   205   162   265   245   227   330   303   

A2   356   679   482   239   446   362   238   347   318   
     351   682   482   233   452   362   238   348   318   
     351   674   481   239   452   362   238   348   318   
     351   682   480   239   452   362   238   348   318   

bg   168   228   205   163   265   245   228   330   297   
     168   228   208   163   265   246   227   331   303   
     168   229   206   163   266   246   228   331   297   
     168   229   206   163   266   246   232   331   304   

A3   194   435   543   175   357   371   233   341   321   
     194   435   543   175   357   371   232   341   321   
     199   434   547   175   356   371   232   341   321   
     194   434   543   175   355   371   232   341   321   

bg   168   227   206   162   265   246   231   324   304   
     171   228   212   162   265   246   227   331   304   
     168   228   205   163   265   246   227   331   304   
     168   229   206   163   265   246   233   331   295   

B1   290   346   238   465   535   316   361   453   340   
     290   346   238   464   535   316   360   453   340   
     290   337   238   461   534   316   360   452   335   
     289   346   242   462   533   316   359   451   340   

bg   167   228   206   162   265   246   232   324   304   
     167   217   206   162   265   246   226   330   304   
     167   228   205   162   265   246   227   330   304   
     171   228   205   162   265   246   226   330   303   

B2   249   416   324   335   732   532   303   496   412   
     249   415   324   329   730   530   303   496   417   
     250   416   324   335   732   531   303   496   418   
     249   411   324   335   730   530   303   495   416   

bg   171   226   209   161   263   243   224   327   301   
     166   226   203   160   262   243   224   326   300   
     165   226   203   160   256   243   228   325   300   
     165   225   203   160   261   243   223   325   300   

B3   182   321   338   183   489   592   242   430   460   
     182   321   338   187   489   592   244   431   451   
     183   322   345   188   490   591   244   432   460   
     184   323   339   188   483   592   245   433   461   

bg   169   230   207   164   267   248   229   333   299   
     169   229   208   163   266   247   228   332   305   
     173   228   206   163   265   246   233   330   304   
     167   228   205   162   265   246   226   330   303   

C1   181   233   213   291   385   288   549   635   384   
     185   242   213   291   385   288   548   635   384   
     181   242   219   290   385   288   548   634   383   
     181   242   213   291   382   287   547   632   383   

bg   168   228   205   162   265   245   227   323   303   
     168   228   205   158   265   245   227   330   300   
     168   225   205   162   259   245   227   330   302   
     167   228   205   162   265   245   227   330   302   

C2   177   244   217   239   443   373   430   825   592   
     177   239   217   233   434   373   428   822   591   
     177   244   217   239   443   373   429   824   592   
     181   244   219   239   436   373   429   824   592   

bg   167   228   205   162   264   245   226   327   302   
     167   228   205   162   264   245   226   329   302   
     167   228   205   162   264   245   226   329   302   
     168   228   205   162   265   245   227   330   302   

C3   179   239   220   175   353   385   251   544   646   
     173   239   220   175   353   386   251   544   646   
     173   238   220   175   353   386   251   545   647   
     173   239   220   175   354   387   251   545   648   

bg   168   229   212   162   260   247   227   331   298   
     167   228   206   162   265   247   227   331   304   
     167   228   205   157   259   246   226   330   301   
     167   228   208   162   265   246   226   330   303   


Trial #7-------------------------

     A1    A2    A3    B1    B2    B3    C1    C2    C3    

A1   472   514   277   286   384   279   247   343   310   
     471   512   277   285   377   279   243   343   310   
     470   512   284   283   384   278   243   343   310   
     469   500   277   284   384   278   243   343   310   

bg   167   225   205   162   262   245   226   329   303   
     171   228   205   157   264   245   226   329   303   
     167   228   205   161   264   245   226   329   303   
     167   228   205   161   264   245   225   329   294   

A2   351   684   481   239   452   361   244   347   317   
     351   683   480   239   452   361   238   346   316   
     351   682   480   239   452   360   238   346   309   
     351   682   479   239   451   360   238   346   316   

bg   167   227   204   162   259   244   226   321   302   
     167   222   204   162   264   245   226   329   302   
     167   227   204   162   264   245   226   329   302   
     171   227   205   161   264   245   225   328   302   

A3   193   431   543   174   355   370   231   339   317   
     193   434   543   174   347   370   231   338   319   
     193   433   541   174   355   369   235   339   319   
     193   425   540   174   355   369   231   339   315   

bg   172   227   210   162   263   244   226   329   302   
     167   228   204   162   264   245   226   329   302   
     167   219   205   157   264   245   226   329   302   
     167   228   205   162   264   245   226   329   302   

B1   287   344   237   460   530   314   356   449   338   
     287   343   239   459   530   314   356   448   329   
     287   343   237   458   530   314   361   448   338   
     287   343   237   458   530   314   356   448   338   

bg   168   228   213   162   265   246   227   330   297   
     167   228   205   158   265   245   227   330   303   
     167   228   205   162   264   245   226   329   302   
     167   227   209   162   264   244   226   329   302   

B2   249   405   324   335   733   532   303   496   418   
     254   415   324   334   730   531   302   495   417   
     249   416   330   335   731   531   303   496   419   
     249   416   325   334   730   531   303   496   419   

bg   169   230   207   163   267   248   229   326   307   
     169   230   208   164   268   249   229   334   304   
     169   230   208   164   268   249   229   334   307   
     169   230   207   163   267   248   229   333   298   

B3   183   321   337   188   489   590   244   432   459   
     183   314   337   187   489   589   248   432   459   
     182   321   337   187   488   588   243   431   458   
     187   321   337   187   487   588   243   430   458   

bg   167   227   204   161   263   244   225   327   302   
     166   227   204   161   263   244   225   328   301   
     166   227   204   155   263   244   224   327   301   
     166   227   204   161   256   244   224   327   301   

C1   180   241   211   291   383   285   549   633   381   
     180   241   218   291   383   286   555   632   381   
     181   241   212   292   384   286   550   633   381   
     181   241   212   292   384   285   550   632   379   

bg   167   227   206   161   263   244   229   328   301   
     167   227   204   157   263   244   225   328   301   
     167   227   204   161   263   244   225   328   298   
     167   227   204   161   263   244   225   328   302   

C2   176   243   216   239   443   374   430   826   593   
     176   243   222   239   443   373   430   825   584   
     177   243   216   240   441   373   430   825   592   
     177   233   216   240   443   373   434   825   591   

bg   167   226   205   162   264   245   226   329   302   
     173   228   205   163   265   245   227   330   303   
     168   218   205   163   265   246   228   331   303   
     168   229   212   162   259   246   227   331   304   

C3   173   238   219   174   352   386   250   544   649   
     173   238   219   174   352   386   250   544   649   
     173   238   222   169   346   386   250   543   642   
     173   238   219   174   352   386   254   543   648   

bg   167   228   205   162   265   245   226   321   303   
     168   228   205   162   265   245   227   330   302   
     168   229   206   157   266   246   232   331   304   
     174   229   206   163   267   247   229   332   305   


Trial #8-------------------------

     A1    A2    A3    B1    B2    B3    C1    C2    C3    

A1   476   514   283   290   391   285   249   351   314   
     475   518   283   289   391   286   249   352   319   
     476   516   282   288   387   285   248   350   319   
     470   514   281   287   388   283   246   348   316   

bg   167   228   205   162   265   246   226   330   303   
     167   228   205   158   258   245   226   329   303   
     167   219   207   162   264   245   228   329   302   
     167   227   204   162   264   244   226   329   302   

A2   352   685   481   240   453   361   238   347   316   
     353   675   488   240   453   361   238   347   317   
     352   684   481   240   446   361   238   347   317   
     351   680   479   234   451   360   238   347   317   

bg   167   227   204   158   263   244   225   328   295   
     166   227   204   161   263   244   228   328   302   
     166   227   204   161   263   244   225   328   302   
     166   225   211   160   263   244   225   328   302   

A3   193   434   541   174   354   369   231   338   318   
     199   433   540   174   354   368   231   338   318   
     193   433   540   169   355   368   231   338   318   
     194   433   539   174   355   368   231   339   318   

bg   167   228   205   162   264   245   226   329   302   
     167   228   205   162   258   245   231   329   302   
     167   227   205   156   264   245   226   329   302   
     167   227   211   161   264   245   225   328   294   

B1   287   343   236   458   522   313   356   448   337   
     287   338   236   459   530   313   356   448   337   
     288   343   236   459   530   313   356   448   337   
     293   337   236   459   529   313   356   448   336   

bg   167   220   204   162   264   244   226   322   302   
     167   228   204   162   264   244   226   329   302   
     172   228   204   162   264   244   226   329   302   
     167   227   204   162   264   245   230   329   302   

B2   248   415   324   334   732   531   302   495   418   
     249   416   324   335   731   532   302   496   419   
     249   416   324   334   732   532   303   497   419   
     249   416   325   329   730   531   303   497   419   

bg   169   231   207   161   268   248   229   334   307   
     170   231   207   164   268   248   229   334   306   
     169   230   208   164   267   247   229   333   302   
     168   229   206   162   266   246   234   332   304   

B3   182   321   337   187   481   591   243   431   459   
     182   320   344   186   488   591   243   430   451   
     182   320   337   181   488   591   246   430   459   
     181   320   337   186   487   590   242   430   458   

bg   166   227   205   161   263   244   225   328   301   
     172   227   204   161   263   244   225   328   301   
     166   216   204   161   263   244   225   327   301   
     167   227   211   161   263   243   225   327   300   

C1   185   241   211   292   384   285   552   634   380   
     180   241   211   292   384   285   551   633   380   
     180   241   211   291   383   285   550   633   374   
     180   241   211   291   381   285   548   632   380   

bg   166   226   203   160   262   243   224   327   300   
     166   226   203   160   262   243   224   327   300   
     166   226   203   160   262   243   224   327   300   
     166   220   203   161   262   243   224   327   300   

C2   176   243   217   239   441   371   428   822   582   
     176   243   215   239   441   371   430   822   588   
     181   243   216   239   442   372   429   821   589   
     177   244   216   235   442   372   429   822   589   

bg   169   230   207   161   268   248   229   330   307   
     169   231   208   164   268   249   230   335   308   
     169   230   207   164   267   248   228   334   307   
     168   229   206   162   266   246   227   331   304   

C3   172   237   218   173   351   385   249   543   647   
     172   228   225   173   351   384   253   542   646   
     172   237   218   168   351   384   249   542   645   
     172   237   217   173   349   383   249   542   643   

bg   167   217   204   162   264   244   226   329   297   
     168   228   205   163   265   245   227   330   303   
     168   229   207   163   260   247   228   332   296   
     169   228   206   163   267   247   228   332   305   

