Trial #5-------------------------

     A1    A2    A3    B1    B2    B3    C1    C2    C3    

A1   456   493   258   265   359   254   220   309   279   
     455   493   263   269   358   254   220   309   279   
     455   492   258   268   358   254   220   309   279   
     454   492   258   266   358   254   220   297   273   

bg   158   209   186   146   239   221   204   295   272   
     153   209   186   146   239   221   204   295   272   
     153   208   186   142   239   221   204   295   272   
     153   208   192   146   234   221   203   313   272   

A2   337   663   461   223   427   337   216   313   286   
     337   663   461   223   426   337   216   313   283   
     337   662   461   223   426   336   216   313   286   
     337   662   460   223   426   336   216   305   286   

bg   153   208   185   146   239   220   204   295   271   
     153   208   185   146   238   220   204   295   271   
     156   208   185   146   238   220   203   295   271   
     153   208   185   146   238   220   203   303   271   

A3   179   414   526   158   329   345   213   305   288   
     179   405   523   157   329   345   208   305   288   
     179   414   522   158   326   344   208   305   279   
     180   413   521   158   329   344   209   295   287   

bg   153   199   185   146   239   220   204   288   271   
     153   209   186   146   239   220   204   296   264   
     153   209   191   146   239   221   204   296   271   
     153   207   186   140   231   221   204   416   272   

B1   277   325   218   438   506   290   335   416   307   
     273   325   221   444   506   290   335   416   307   
     273   319   218   443   505   290   338   415   307   
     274   325   218   443   505   290   334   297   308   

bg   154   209   187   147   240   222   205   295   273   
     154   209   187   147   237   222   205   297   273   
     154   209   192   147   240   222   205   296   266   
     154   209   186   147   240   221   205   339   272   

B2   234   396   304   317   697   505   280   461   386   
     234   395   304   317   702   505   280   461   386   
     239   396   305   318   695   506   280   462   387   
     234   396   305   318   703   506   280   351   387   

bg   153   199   186   146   239   222   204   296   268   
     157   209   186   146   239   221   204   296   272   
     153   209   186   146   239   221   204   296   272   
     153   209   186   146   239   221   205   398   272   

B3   169   302   319   171   462   568   222   398   429   
     169   302   319   166   464   567   222   398   428   
     168   293   319   171   464   566   221   397   428   
     168   302   319   171   463   566   221   346   428   

bg   155   209   186   146   239   221   207   296   272   
     153   199   189   146   239   221   204   296   272   
     153   209   187   146   240   222   204   296   273   
     158   209   187   145   240   222   209   533   273   

C1   167   224   201   273   358   263   530   602   346   
     167   224   194   276   360   263   530   602   352   
     167   224   194   276   360   263   530   602   352   
     167   217   199   276   360   263   530   296   352   

bg   154   209   186   146   240   221   210   288   272   
     154   209   186   146   240   221   205   296   272   
     153   209   189   146   240   221   206   297   272   
     154   209   187   146   240   222   204   297   273   

C2   163   226   199   224   417   350   407   791   562   
     165   226   199   224   417   349   407   790   561   
     164   226   199   222   418   349   407   790   561   
     164   226   204   224   418   349   407   790   553   

bg   154   210   187   147   241   222   206   299   274   
     154   210   187   147   241   223   206   299   274   
     155   210   188   148   241   223   212   299   274   
     155   211   188   148   242   223   206   369   275   

C3   160   216   202   160   329   363   230   512   620   
     160   221   202   153   329   363   230   512   620   
     160   221   202   160   329   363   229   512   619   
     163   221   202   159   323   363   229   355   619   

bg   154   210   188   147   241   223   206   298   274   
     154   210   187   147   241   222   206   298   274   
     154   200   187   147   234   222   206   298   274   
     154   210   187   147   241   222   206   312   268   


Trial #6-------------------------

     A1    A2    A3    B1    B2    B3    C1    C2    C3    

A1   459   497   260   271   362   257   222   312   282   
     458   485   260   270   361   257   222   312   282   
     456   495   264   270   361   257   222   312   283   
     455   494   260   269   361   257   226   306   283   

bg   154   211   188   147   241   224   206   299   275   
     155   211   195   148   242   224   206   299   270   
     155   211   188   148   238   224   206   300   275   
     155   203   188   148   242   224   207   313   275   

A2   340   668   465   226   431   340   224   318   290   
     340   668   465   226   424   340   220   318   291   
     340   668   465   220   431   341   220   318   291   
     340   667   467   226   423   341   220   301   291   

bg   155   212   189   148   243   225   207   294   277   
     160   212   189   148   243   225   207   301   277   
     155   212   189   148   243   225   207   301   268   
     157   212   189   148   243   225   207   306   277   

A3   182   417   525   161   334   349   214   313   294   
     182   411   524   161   334   349   214   313   288   
     183   417   524   162   335   349   219   314   295   
     183   418   523   162   335   349   215   306   295   

bg   157   214   198   150   239   228   210   306   280   
     157   214   192   151   246   228   210   306   281   
     157   215   192   151   247   229   211   306   282   
     158   205   192   151   247   229   211   427   282   

B1   278   330   225   444   515   299   343   429   319   
     278   332   225   449   516   299   343   429   320   
     283   322   226   450   516   300   344   430   314   
     280   333   226   446   516   300   344   311   321   

bg   160   218   201   151   251   233   215   313   287   
     160   218   196   154   252   233   215   313   288   
     160   219   196   154   252   234   216   314   288   
     161   219   198   155   252   234   218   467   289   

B2   242   406   316   327   718   521   292   481   400   
     246   406   316   327   718   520   292   481   405   
     242   407   323   322   718   520   293   481   406   
     243   407   316   327   717   520   293   435   406   

bg   166   219   199   156   255   237   222   318   292   
     162   221   199   156   255   237   219   318   293   
     163   221   199   157   256   237   219   318   293   
     163   222   199   157   256   237   225   395   293   

B3   177   314   332   182   480   584   236   420   450   
     177   314   332   178   480   584   236   419   450   
     177   314   332   181   476   584   235   419   450   
     177   314   332   181   479   583   235   317   450   

bg   162   220   198   156   254   237   220   316   285   
     162   219   198   155   254   237   217   316   292   
     166   220   198   156   254   236   220   316   287   
     161   220   197   153   246   236   217   431   291   

C1   174   233   204   279   372   275   539   617   368   
     174   233   209   283   371   275   538   615   367   
     174   233   203   283   371   275   538   614   367   
     174   222   204   276   371   275   536   377   367   

bg   161   215   200   149   253   235   216   314   290   
     161   219   197   155   251   235   216   314   290   
     161   212   197   155   253   235   221   314   290   
     160   219   197   154   247   235   216   313   281   

C2   171   234   207   231   429   360   418   806   576   
     170   234   212   231   429   360   417   805   575   
     170   234   207   230   421   360   417   804   567   
     169   234   207   231   428   359   417   804   574   

bg   159   217   194   153   249   231   213   309   285   
     159   216   194   153   249   231   213   309   285   
     158   216   194   152   249   231   212   308   284   
     158   216   200   152   249   231   212   517   284   

C3   164   226   208   164   333   369   236   520   626   
     164   226   207   158   335   369   236   520   625   
     167   226   208   164   335   369   236   520   625   
     164   226   207   164   335   368   239   447   618   

bg   158   215   192   152   248   229   212   305   282   
     158   215   192   147   240   229   212   307   282   
     158   212   192   151   247   229   212   307   281   
     158   215   192   151   247   229   211   317   282   


Trial #7-------------------------

     A1    A2    A3    B1    B2    B3    C1    C2    C3    

A1   460   500   267   274   366   263   232   320   290   
     459   499   265   273   367   263   227   320   287   
     458   498   265   273   366   263   227   320   290   
     457   498   264   272   366   263   228   306   290   

bg   158   215   192   152   247   229   212   307   273   
     158   212   192   152   247   229   212   307   282   
     158   215   197   152   247   229   212   307   282   
     162   206   192   152   247   229   212   312   282   

A2   342   664   468   229   435   345   224   324   296   
     342   670   473   229   435   345   224   324   296   
     341   669   467   223   434   345   228   324   297   
     341   668   467   229   434   345   224   311   297   

bg   163   215   192   152   247   229   212   306   282   
     158   215   192   152   247   229   213   306   274   
     158   215   196   150   247   228   212   306   282   
     158   215   192   152   247   229   212   316   281   

A3   184   419   525   164   337   352   217   317   292   
     184   419   525   161   337   351   217   317   298   
     184   419   525   164   337   352   218   318   298   
     185   419   526   165   333   352   218   314   299   

bg   159   216   194   153   249   231   214   308   285   
     159   216   193   153   248   230   213   307   284   
     161   215   193   152   247   229   212   306   283   
     158   215   195   152   247   229   212   425   282   

B1   277   330   223   447   511   296   342   425   316   
     277   329   223   447   510   296   342   425   313   
     277   330   223   448   511   296   342   425   316   
     278   330   223   445   510   296   342   306   316   

bg   158   215   192   151   247   229   215   306   282   
     158   215   193   152   247   229   212   307   282   
     158   215   192   152   244   229   212   307   282   
     158   215   192   152   247   229   217   395   282   

B2   242   401   316   323   710   512   288   471   396   
     239   396   310   323   702   512   288   472   396   
     239   401   310   317   708   512   288   472   396   
     241   395   314   322   702   512   288   317   396   

bg   158   207   192   152   248   229   217   308   282   
     158   215   193   152   248   229   212   308   283   
     158   216   200   152   248   230   213   308   283   
     158   216   193   152   248   230   212   343   284   

B3   173   308   325   177   471   574   229   409   440   
     173   308   325   176   469   573   229   409   439   
     178   306   325   176   470   574   229   408   439   
     173   308   327   176   470   573   229   330   439   

bg   158   215   193   152   242   229   212   308   283   
     162   215   193   152   248   229   212   308   283   
     158   215   193   152   241   229   218   309   283   
     158   216   193   152   248   230   212   612   283   

C1   172   231   201   281   368   272   535   612   364   
     172   231   202   281   366   273   539   612   364   
     172   231   202   281   368   273   533   612   364   
     172   229   202   275   369   273   533   491   365   

bg   162   208   195   148   250   232   214   311   286   
     159   217   195   153   250   232   214   311   286   
     160   218   195   153   251   232   214   312   281   
     165   218   195   154   251   233   215   312   287   

C2   171   235   208   232   430   361   419   809   578   
     171   235   208   232   431   362   419   808   578   
     171   231   208   232   430   362   419   807   577   
     170   235   208   232   431   362   423   808   577   

bg   161   220   197   155   248   235   217   316   291   
     161   212   203   155   254   236   217   316   291   
     161   220   198   155   254   236   217   316   291   
     161   220   198   155   254   236   217   443   283   

C3   167   231   214   168   341   374   246   529   630   
     171   231   212   168   341   375   242   528   632   
     168   231   212   168   341   374   242   528   624   
     168   231   220   169   342   375   245   318   631   

bg   163   222   200   157   256   238   220   320   294   
     163   222   200   154   257   239   220   320   295   
     163   219   200   157   257   239   220   321   296   
     163   223   201   158   258   240   220   320   296   


Trial #8-------------------------

     A1    A2    A3    B1    B2    B3    C1    C2    C3    

A1   468   510   274   280   379   275   238   336   305   
     467   509   274   281   379   275   238   337   306   
     467   509   274   281   379   275   242   337   306   
     470   508   274   277   379   275   239   327   299   

bg   165   225   207   154   260   242   223   325   299   
     165   225   203   160   260   242   224   325   299   
     165   225   203   160   261   243   223   325   297   
     165   226   203   160   258   243   224   343   300   

A2   349   668   479   237   449   360   236   345   316   
     349   679   479   238   449   360   237   345   317   
     349   679   479   238   443   360   238   346   317   
     349   679   479   238   450   361   237   340   318   

bg   167   228   208   162   264   246   226   330   297   
     170   228   208   162   265   246   232   331   304   
     168   221   206   162   265   247   227   331   305   
     168   229   206   163   265   247   227   338   303   

A3   195   434   543   176   357   372   234   343   324   
     195   426   543   172   357   373   234   344   325   
     195   435   548   176   357   373   234   344   325   
     195   435   543   177   358   373   234   334   325   

bg   169   231   209   164   268   250   231   335   309   
     169   231   213   158   262   250   230   335   301   
     170   231   209   165   268   251   230   336   310   
     174   229   210   165   269   251   236   452   310   

B1   290   348   242   463   527   321   362   457   340   
     290   348   243   463   535   321   362   458   348   
     294   349   243   463   532   321   363   458   348   
     290   349   243   463   535   321   362   339   348   

bg   171   234   212   167   272   254   238   340   314   
     171   234   212   167   272   254   233   340   315   
     172   234   212   167   272   255   233   340   315   
     172   234   213   167   272   255   234   506   315   

B2   253   421   331   339   731   539   310   506   430   
     253   410   334   339   736   538   310   505   423   
     253   420   330   339   734   538   310   506   429   
     253   421   331   339   736   539   310   417   423   

bg   172   226   220   167   273   255   234   341   314   
     172   234   213   167   265   255   234   340   315   
     172   234   213   162   272   255   238   340   315   
     171   227   212   167   272   254   233   440   314   

B3   186   326   344   191   494   598   249   439   469   
     190   326   345   191   494   598   253   440   469   
     186   317   347   191   494   597   249   439   469   
     186   326   343   191   493   596   249   401   468   

bg   176   233   211   166   270   252   232   336   312   
     170   232   210   164   270   252   231   336   311   
     170   232   210   165   269   251   231   335   311   
     170   231   214   165   268   251   230   531   303   

C1   182   245   217   293   387   291   551   637   388   
     182   245   216   293   387   291   552   636   388   
     182   244   221   292   386   291   550   635   387   
     182   244   215   292   386   290   553   331   387   

bg   168   229   207   157   265   247   227   330   305   
     168   228   206   163   264   246   227   329   304   
     170   228   206   162   264   246   226   329   304   
     167   228   205   158   263   246   226   322   303   

C2   176   243   216   236   438   371   430   817   589   
     175   242   216   237   438   370   425   815   588   
     175   242   216   236   438   370   424   814   587   
     175   241   215   237   432   369   427   814   585   

bg   165   224   202   159   259   241   222   322   298   
     164   214   202   159   259   241   222   322   297   
     164   224   204   153   258   241   221   321   295   
     164   223   201   158   258   240   221   534   296   

C3   173   228   214   170   344   378   244   532   637   
     169   233   221   170   344   378   243   532   627   
     168   232   214   169   344   378   247   531   636   
     168   224   214   169   343   377   242   400   636   

bg   162   221   199   156   255   237   218   317   293   
     162   221   199   154   255   237   218   316   292   
     162   211   199   156   253   237   218   316   292   
     162   220   203   156   254   236   217   329   291   

