     A1    A2    A3    B1    B2    B3    C1    C2    C3    

On   42    83    61    56    102   75    47    98    72    
     42    83    61    57    102   75    47    98    72    
     42    83    61    56    102   75    47    98    71    
     42    83    61    56    102   75    47    98    71    

Off  0     0     0     0     0     0     0     0     0     
     0     0     0     0     0     0     0     0     0     
     0     0     0     0     0     0     0     0     0     
     0     0     0     0     0     0     0     0     0     

