     A1    A2    A3    B1    B2    B3    C1    C2    C3    

On   44    85    63    58    105   79    50    101   75    
     44    84    62    59    104   76    49    102   74    
     43    84    62    58    105   77    49    101   74    
     44    85    62    58    104   77    49    102   74    

Off  0     0     0     0     76    0     0     0     0     
     0     0     0     0     0     0     0     0     0     
     0     0     0     0     0     0     0     0     0     
     0     0     0     0     0     0     0     0     0     

