     A1    A2    A3    B1    B2    B3    C1    C2    C3    

On   44    86    63    58    104   77    48    98    71    
     44    85    63    58    104   77    48    98    71    
     43    85    63    58    104   77    48    98    71    
     43    85    62    57    102   75    46    95    71    

Off  0     0     0     0     0     0     0     0     0     
     0     0     0     0     0     0     0     0     0     
     0     0     0     0     0     0     0     0     0     
     0     0     0     0     0     0     0     0     0     

