Trial #13-------------------------

     A1    A2    A3    B1    B2    B3    C1    C2    C3    

A1   209   220   111   126   161   113   98    140   127   
     208   219   111   126   161   113   98    140   127   
     207   218   111   125   160   112   97    139   126   
     206   218   110   125   160   112   97    139   126   

bg   53    73    73    62    98    94    88    132   122   
     53    73    73    62    98    94    88    132   122   
     53    73    73    62    98    94    88    132   122   
     53    73    73    62    98    94    88    132   122   

A2   147   303   214   102   195   154   94    141   129   
     147   303   214   102   194   154   94    141   129   
     147   303   213   102   194   153   94    141   129   
     147   302   213   102   194   153   94    141   129   

bg   53    73    73    62    98    94    88    132   122   
     53    73    73    62    98    94    88    132   122   
     53    73    73    62    98    94    88    132   122   
     53    73    72    62    98    94    88    132   121   

A3   66    178   245   69    145   158   91    137   130   
     67    178   245   69    145   158   91    137   130   
     67    178   244   69    145   158   91    137   130   
     67    178   244   69    145   158   91    137   130   

bg   53    73    72    62    97    94    88    131   121   
     53    73    72    62    97    94    88    131   121   
     53    73    73    62    98    94    88    132   122   
     53    73    73    62    98    94    88    132   122   

B1   114   133   89    214   235   130   156   194   140   
     114   133   89    214   235   130   156   194   140   
     114   133   89    214   235   130   155   194   140   
     114   133   89    213   234   130   155   194   140   

bg   53    73    73    62    98    95    88    132   122   
     53    73    73    62    98    94    88    132   122   
     53    73    73    62    98    94    88    132   122   
     53    73    73    62    98    94    88    132   122   

B2   95    169   134   151   337   240   128   218   181   
     95    169   134   151   336   240   128   217   181   
     95    169   134   151   336   240   128   217   181   
     95    169   134   151   335   239   128   217   181   

bg   53    73    73    62    98    94    88    132   122   
     53    73    73    62    98    94    88    132   122   
     53    73    73    62    98    94    88    132   122   
     53    73    73    62    98    94    88    132   122   

B3   61    121   141   75    214   271   97    185   202   
     61    121   141   75    213   271   97    185   202   
     61    121   141   75    213   270   97    184   202   
     61    121   141   75    213   270   97    184   202   

bg   52    73    73    62    98    94    88    132   121   
     52    73    73    62    97    94    88    132   121   
     53    73    73    62    98    94    88    132   121   
     53    73    73    62    98    94    88    132   122   

C1   60    80    76    128   159   115   253   287   162   
     60    80    76    128   159   115   252   287   162   
     60    80    76    128   159   115   252   287   162   
     60    80    76    128   159   115   252   286   162   

bg   53    73    73    62    98    94    88    132   122   
     53    73    73    62    98    94    88    132   122   
     53    73    73    62    98    94    88    132   122   
     53    73    73    62    98    94    88    132   122   

C2   58    81    79    102   189   159   191   382   268   
     58    81    79    102   189   159   191   382   268   
     58    81    79    102   189   159   191   382   268   
     58    81    79    102   189   159   191   382   268   

bg   53    73    73    62    98    95    88    132   122   
     53    73    73    62    98    95    88    133   122   
     53    73    73    62    98    95    88    133   122   
     53    73    73    62    98    95    89    133   122   

C3   56    78    80    68    143   165   100   241   296   
     56    78    80    68    143   165   100   240   295   
     56    78    80    68    143   165   100   240   295   
     56    78    80    68    143   165   100   240   295   

bg   52    73    72    62    97    94    88    131   121   
     52    73    72    62    97    94    88    131   121   
     52    73    72    62    97    94    88    131   121   
     52    73    73    62    98    94    88    131   121   


Trial #14-------------------------

     A1    A2    A3    B1    B2    B3    C1    C2    C3    

A1   207   218   110   125   160   112   96    138   125   
     206   217   110   125   159   112   96    138   125   
     205   217   110   124   159   112   96    138   125   
     205   216   110   124   159   112   96    139   126   

bg   53    73    73    62    98    95    88    132   122   
     53    73    73    62    98    95    88    133   122   
     53    73    73    62    98    95    88    133   122   
     53    73    73    62    98    94    88    132   122   

A2   148   304   215   102   195   154   94    141   129   
     147   304   214   102   195   154   94    141   129   
     147   304   214   102   195   154   94    141   129   
     147   303   214   102   194   154   94    141   129   

bg   52    73    72    62    97    94    88    131   121   
     52    73    72    62    97    94    88    131   121   
     53    73    73    62    97    94    88    132   121   
     53    73    73    62    98    94    88    132   122   

A3   67    178   245   69    145   158   91    137   130   
     67    178   245   69    145   158   91    137   130   
     67    178   245   69    145   157   91    137   129   
     67    177   243   69    145   157   91    137   130   

bg   53    73    72    62    97    94    88    131   121   
     53    73    72    62    97    94    88    131   121   
     53    73    73    62    98    94    88    132   121   
     53    73    73    62    98    94    89    132   122   

B1   114   133   90    215   236   130   156   194   140   
     114   133   89    214   235   130   155   194   140   
     114   133   89    214   235   130   155   194   140   
     114   132   89    214   234   130   155   193   140   

bg   53    73    73    62    98    94    88    132   121   
     53    73    73    62    98    94    88    131   121   
     52    73    72    62    97    94    88    131   121   
     52    73    72    62    97    94    88    131   121   

B2   94    168   134   151   337   240   127   217   181   
     95    168   134   151   336   240   127   217   181   
     95    168   134   151   335   240   127   217   181   
     95    168   134   150   335   239   127   217   181   

bg   53    73    73    62    97    94    88    131   121   
     53    73    73    62    98    94    88    132   121   
     53    73    73    62    98    94    88    132   121   
     53    73    73    62    98    94    88    132   121   

B3   60    120   140   75    212   269   97    183   201   
     60    120   140   75    212   269   96    183   201   
     60    120   140   75    212   269   96    183   201   
     60    120   140   75    212   269   97    183   201   

bg   53    73    72    62    97    94    88    131   121   
     53    73    72    62    97    94    88    131   121   
     53    73    73    62    97    94    88    131   121   
     53    73    72    62    97    94    88    131   121   

C1   60    80    77    129   159   115   253   287   162   
     60    80    76    129   159   115   253   287   162   
     60    80    76    129   159   115   253   286   162   
     60    80    76    129   159   115   252   286   162   

bg   53    73    72    62    97    94    88    131   121   
     53    73    72    62    97    94    88    131   121   
     53    73    72    62    97    94    88    131   121   
     53    73    72    62    97    93    88    131   121   

C2   58    81    79    102   189   159   191   383   268   
     58    81    79    102   189   159   191   382   268   
     58    81    79    102   189   159   191   382   268   
     58    81    79    102   189   159   191   381   268   

bg   53    73    73    62    97    94    88    131   121   
     53    73    72    62    97    94    88    131   121   
     53    73    72    62    97    94    88    131   121   
     53    73    72    62    97    94    88    131   121   

C3   56    78    79    68    142   164   100   240   295   
     56    78    79    68    142   164   100   240   295   
     56    78    79    68    142   164   100   240   295   
     56    78    79    68    142   165   100   240   295   

bg   53    73    72    62    97    94    88    131   121   
     53    73    72    62    97    94    88    131   121   
     53    73    72    62    97    94    88    131   121   
     53    73    73    62    97    94    88    131   121   


Trial #15-------------------------

     A1    A2    A3    B1    B2    B3    C1    C2    C3    

A1   208   218   110   125   160   112   96    138   125   
     207   218   110   125   160   112   97    138   125   
     206   217   110   125   159   111   96    138   125   
     206   217   110   124   159   111   96    138   125   

bg   53    73    72    62    97    94    88    131   121   
     53    73    72    62    97    94    88    131   121   
     53    73    72    62    97    94    88    131   121   
     53    73    72    62    97    94    88    131   121   

A2   148   305   215   103   195   154   94    140   129   
     148   305   214   102   195   154   94    140   129   
     148   304   214   102   195   154   94    140   129   
     148   304   214   102   195   153   94    140   129   

bg   53    73    72    62    97    94    88    131   121   
     53    73    72    62    97    94    88    131   121   
     53    73    72    62    97    94    88    131   121   
     53    73    72    62    97    94    88    131   121   

A3   67    177   244   69    144   157   91    136   129   
     67    177   244   69    144   157   91    137   129   
     67    177   244   69    144   157   91    136   129   
     67    177   243   69    144   157   91    136   129   

bg   53    73    73    62    97    94    88    131   121   
     53    73    72    62    97    94    88    131   121   
     53    73    72    62    97    94    88    131   121   
     53    73    72    62    97    94    88    131   121   

B1   114   132   89    213   234   129   155   193   139   
     114   132   89    213   233   129   155   193   139   
     114   132   89    213   233   129   155   192   139   
     114   132   89    213   233   129   155   192   139   

bg   53    73    72    62    97    94    88    131   121   
     53    73    73    62    97    94    88    131   121   
     53    73    73    62    97    94    88    131   121   
     53    73    73    62    98    94    88    131   121   

B2   95    169   134   151   336   240   127   217   180   
     95    168   134   151   336   239   127   216   180   
     95    168   133   150   335   239   127   216   180   
     95    168   133   150   335   238   127   216   180   

bg   53    73    72    62    97    93    87    131   120   
     53    73    72    62    97    94    88    131   121   
     53    73    72    62    97    94    88    131   121   
     53    73    72    62    97    94    88    131   121   

B3   60    120   140   75    212   269   96    183   201   
     60    120   140   75    212   269   96    183   200   
     61    120   140   75    212   268   96    183   201   
     61    120   140   75    212   268   96    183   200   

bg   53    73    72    62    97    94    88    131   121   
     53    73    72    62    97    94    88    131   121   
     53    73    72    62    97    93    88    131   121   
     53    73    72    62    97    93    87    131   120   

C1   60    80    76    128   159   115   252   285   162   
     60    80    76    128   159   115   251   285   162   
     60    80    76    128   159   115   251   285   162   
     60    80    76    128   159   115   251   285   162   

bg   53    73    72    62    97    94    88    131   121   
     53    73    72    62    97    94    88    131   121   
     53    73    72    62    97    94    88    131   121   
     53    73    72    62    97    94    88    131   121   

C2   58    81    78    102   189   159   192   383   268   
     58    81    79    102   189   159   192   383   268   
     58    81    78    102   189   159   192   383   268   
     58    81    78    102   189   159   191   382   268   

bg   53    73    72    62    97    93    88    131   121   
     53    73    72    62    97    93    88    131   121   
     53    73    72    62    97    93    88    131   121   
     53    73    72    62    97    93    87    131   120   

C3   56    78    79    68    142   164   100   239   294   
     56    78    79    68    142   164   100   239   294   
     56    78    79    68    142   164   100   239   294   
     56    78    79    68    142   164   100   239   294   

bg   53    73    72    62    97    94    88    131   121   
     53    73    72    62    97    94    88    131   121   
     53    73    72    62    97    94    88    131   121   
     53    73    72    62    97    94    88    131   121   


Trial #16-------------------------

     A1    A2    A3    B1    B2    B3    C1    C2    C3    

A1   208   219   110   125   160   111   96    138   125   
     207   218   110   125   159   111   96    138   125   
     206   217   110   124   159   111   96    137   125   
     206   217   110   124   159   111   96    137   124   

bg   52    72    72    61    97    93    87    130   120   
     52    72    72    61    97    93    87    131   120   
     52    72    72    62    97    94    87    131   121   
     52    73    73    62    97    94    88    131   121   

A2   147   303   213   102   194   153   94    140   128   
     147   303   213   102   194   153   94    140   128   
     147   303   213   102   194   153   94    140   128   
     146   302   213   102   194   153   94    140   128   

bg   52    72    72    62    97    94    88    131   121   
     52    72    72    62    97    94    88    131   121   
     52    72    72    62    97    94    88    131   121   
     52    72    72    62    97    94    88    131   121   

A3   66    178   245   69    145   157   91    137   129   
     67    178   244   69    145   158   91    137   130   
     67    178   245   69    145   158   91    138   130   
     67    178   245   70    146   158   92    138   131   

bg   54    74    74    64    100   96    90    135   124   
     54    74    73    63    100   96    89    134   124   
     53    73    73    63    98    95    89    132   122   
     52    72    72    62    97    94    88    131   121   

B1   113   131   88    213   233   128   154   192   138   
     113   131   88    213   233   128   154   192   138   
     114   132   88    213   233   129   154   192   138   
     114   132   88    213   233   129   154   192   139   

bg   52    72    72    62    97    93    88    131   120   
     52    72    72    62    97    93    88    131   121   
     52    72    72    62    97    94    88    131   121   
     52    72    72    62    97    94    88    131   121   

B2   94    168   133   150   335   239   127   216   180   
     94    168   133   150   335   238   127   216   180   
     94    168   133   150   334   238   127   216   179   
     94    168   133   150   334   238   127   216   179   

bg   52    72    72    62    97    93    88    131   121   
     52    72    72    62    97    94    88    131   121   
     52    72    72    62    97    93    88    131   121   
     52    72    72    62    97    93    88    131   121   

B3   60    120   140   75    212   270   96    183   201   
     60    120   140   75    212   269   96    183   201   
     60    120   140   75    212   269   96    183   201   
     60    120   140   75    212   269   96    183   200   

bg   52    72    72    62    97    93    87    131   120   
     52    72    72    62    97    93    87    131   120   
     52    72    72    62    97    93    87    131   120   
     52    72    72    62    97    93    87    131   120   

C1   59    80    76    128   159   115   252   286   162   
     59    79    76    128   159   115   252   285   161   
     59    79    76    128   158   115   252   285   161   
     59    80    76    128   159   115   251   285   161   

bg   52    72    72    62    97    93    88    131   120   
     52    72    72    62    97    93    88    131   120   
     52    72    72    62    97    93    87    131   120   
     52    72    72    62    97    93    87    130   120   

C2   57    80    78    101   188   158   191   381   267   
     57    80    78    101   188   158   190   381   267   
     57    80    78    101   188   158   190   380   267   
     57    80    78    102   188   158   190   380   267   

bg   52    72    72    62    97    93    87    131   120   
     52    72    72    62    97    93    87    131   120   
     52    72    72    62    97    93    87    131   120   
     52    72    72    62    97    93    87    131   120   

C3   55    78    79    68    142   164   100   239   294   
     55    78    79    68    142   164   100   239   294   
     55    78    79    68    142   164   100   239   294   
     55    78    79    68    142   164   100   239   294   

bg   52    72    72    62    97    93    87    130   120   
     52    72    72    62    97    93    87    131   120   
     52    72    72    62    97    93    87    131   120   
     52    73    72    62    97    94    88    131   121   

