Trial #13-------------------------

     A1    A2    A3    B1    B2    B3    C1    C2    C3    

A1   184   186   78    97    116   70    56    79    71    
     183   185   78    96    116   70    56    79    71    
     182   185   78    96    115   70    56    79    71    
     181   184   78    96    115   70    56    79    71    

bg   29    40    40    34    54    52    48    72    66    
     29    40    40    34    54    52    48    72    66    
     29    40    40    34    54    52    48    72    66    
     29    40    40    34    54    52    48    72    66    

A2   123   271   181   74    150   112   54    81    74    
     123   270   181   74    150   112   54    81    74    
     123   270   181   73    150   111   54    81    74    
     123   270   181   73    150   111   54    81    74    

bg   29    40    40    34    54    52    48    72    66    
     29    40    40    34    54    52    48    72    66    
     29    40    40    34    54    52    48    72    66    
     29    40    40    34    54    52    48    72    66    

A3   43    145   212   40    101   116   50    77    75    
     43    145   212   40    101   116   50    77    75    
     43    145   211   40    101   115   51    77    75    
     43    144   211   40    101   115   51    77    75    

bg   29    40    40    34    54    52    48    72    67    
     29    40    40    34    54    52    48    72    67    
     29    40    40    34    54    52    48    72    67    
     29    40    40    34    54    52    48    72    66    

B1   90    99    57    185   190   87    114   133   85    
     90    99    57    184   189   87    114   133   85    
     90    99    57    184   189   87    114   133   84    
     90    99    57    184   189   87    114   132   84    

bg   29    40    40    34    54    52    48    72    66    
     29    40    40    34    54    52    48    72    66    
     29    40    40    34    54    52    48    72    66    
     29    40    40    34    54    52    48    72    66    

B2   71    136   102   122   292   198   87    157   126   
     71    136   102   122   291   198   87    157   126   
     71    136   102   122   291   197   87    157   126   
     71    136   102   122   290   197   87    156   125   

bg   29    40    40    34    54    52    48    72    67    
     29    40    40    34    54    52    48    72    67    
     29    40    40    34    54    52    48    72    67    
     29    40    40    34    54    52    48    72    66    

B3   36    87    108   47    168   228   56    124   146   
     36    87    108   47    168   228   56    124   146   
     37    87    108   47    168   227   56    124   146   
     37    88    108   47    168   227   56    124   146   

bg   29    40    40    34    54    52    48    72    66    
     29    40    40    34    54    52    48    72    66    
     29    40    40    34    54    52    48    72    67    
     29    40    40    34    54    52    48    72    67    

C1   36    48    44    100   116   74    213   228   108   
     36    48    44    100   116   74    213   228   108   
     36    48    44    100   116   74    212   228   108   
     36    48    44    100   116   74    212   227   108   

bg   29    40    40    34    54    52    48    72    67    
     29    40    40    34    54    52    48    72    67    
     29    40    40    34    54    53    48    72    67    
     29    40    41    34    54    53    48    72    67    

C2   34    49    47    74    146   118   152   324   215   
     34    49    47    74    146   118   152   324   214   
     34    49    47    74    146   118   152   323   214   
     34    49    46    74    146   118   151   323   214   

bg   29    40    40    34    54    52    48    72    67    
     29    40    40    34    54    52    48    72    67    
     29    40    40    34    54    52    48    72    67    
     29    40    40    34    54    52    48    72    67    

C3   32    46    48    40    99    123   60    181   241   
     32    46    48    40    99    123   60    181   240   
     32    46    48    40    99    123   60    180   240   
     32    46    48    40    99    123   60    181   240   

bg   29    40    41    34    54    52    48    72    67    
     29    40    41    34    54    53    48    72    67    
     29    40    41    34    54    52    48    72    67    
     29    40    40    34    54    52    48    72    67    


Trial #14-------------------------

     A1    A2    A3    B1    B2    B3    C1    C2    C3    

A1   183   185   78    96    116   70    56    79    71    
     182   184   78    96    115   70    56    79    71    
     181   184   78    96    115   70    56    79    71    
     181   183   78    95    115   70    56    79    71    

bg   29    40    40    34    54    52    48    72    67    
     29    40    40    34    54    52    48    72    67    
     29    40    40    34    54    52    48    72    67    
     29    40    40    34    54    52    48    72    67    

A2   123   271   182   74    150   112   54    81    74    
     123   271   181   74    150   112   54    81    74    
     123   270   181   74    150   112   54    81    74    
     123   270   181   74    150   112   54    81    74    

bg   29    40    40    34    54    52    48    72    67    
     29    40    40    34    54    52    48    72    67    
     29    40    40    34    54    52    48    72    67    
     29    40    40    34    54    52    48    72    67    

A3   43    145   212   40    101   116   51    77    75    
     43    145   212   40    101   116   51    77    75    
     43    145   212   40    101   116   50    77    75    
     43    145   211   40    101   115   50    77    75    

bg   29    40    40    34    54    52    48    72    67    
     29    40    40    34    54    52    48    72    67    
     29    40    40    34    54    52    48    72    67    
     29    40    40    34    54    52    48    72    67    

B1   90    99    57    185   190   88    114   133   85    
     90    99    57    185   190   88    114   133   85    
     90    99    57    185   190   88    114   133   85    
     90    99    57    184   190   88    114   133   85    

bg   29    40    41    34    54    53    48    73    67    
     29    41    41    34    54    53    48    73    68    
     29    41    41    34    55    53    48    73    68    
     29    41    41    34    55    53    48    73    68    

B2   71    136   102   123   293   198   87    158   126   
     71    136   102   122   292   198   87    157   126   
     71    136   101   122   291   197   87    157   125   
     71    136   101   122   290   197   87    156   125   

bg   29    40    40    34    53    52    47    72    66    
     29    40    40    34    54    52    47    72    66    
     29    40    40    34    54    52    48    72    66    
     29    40    40    34    54    52    48    72    66    

B3   37    88    108   47    169   228   56    124   147   
     37    88    108   47    169   228   56    124   147   
     37    88    108   47    168   228   56    124   146   
     37    88    108   47    168   227   56    124   146   

bg   29    40    40    34    54    52    47    72    66    
     29    40    40    34    54    52    47    72    66    
     29    40    40    34    54    52    47    72    66    
     29    40    40    34    54    52    47    72    66    

C1   36    47    44    100   115   73    212   227   107   
     36    47    44    100   115   73    211   226   107   
     36    47    44    100   115   73    211   226   107   
     36    47    44    99    115   73    211   226   107   

bg   29    40    40    34    54    52    48    72    66    
     29    40    40    34    54    52    48    72    67    
     29    40    41    34    54    53    48    72    67    
     29    40    41    34    54    53    48    72    67    

C2   34    48    46    74    146   118   152   324   214   
     34    48    46    74    146   118   152   324   214   
     34    48    46    74    146   118   151   323   214   
     34    48    46    74    146   118   151   323   214   

bg   29    40    40    34    54    52    47    72    66    
     29    40    40    34    53    52    47    72    66    
     29    40    40    34    53    52    47    72    66    
     29    40    40    34    54    52    48    72    66    

C3   32    46    48    40    99    123   60    181   241   
     32    46    48    40    99    123   60    181   241   
     32    46    48    40    99    124   60    181   241   
     32    46    48    40    99    124   60    181   241   

bg   29    40    40    34    54    53    48    72    67    
     29    40    40    34    54    52    48    72    67    
     29    40    40    34    54    52    48    72    67    
     29    40    40    34    54    52    48    72    66    


Trial #15-------------------------

     A1    A2    A3    B1    B2    B3    C1    C2    C3    

A1   184   185   78    96    116   70    56    78    70    
     183   185   78    96    115   70    56    78    70    
     181   184   78    96    115   69    56    78    70    
     181   183   77    95    114   69    55    78    70    

bg   29    40    40    34    53    52    47    71    66    
     29    40    40    34    53    52    47    71    66    
     29    40    40    34    53    52    47    72    66    
     29    40    40    34    54    52    48    72    66    

A2   124   272   182   74    151   112   54    81    74    
     124   271   182   74    151   112   54    81    74    
     123   271   182   74    150   112   54    81    74    
     123   271   181   74    150   112   54    81    74    

bg   29    40    40    34    54    52    48    72    66    
     29    40    40    34    54    52    48    72    66    
     29    40    40    34    54    52    48    72    66    
     29    40    40    34    54    52    48    72    66    

A3   42    144   212   40    100   115   50    77    75    
     43    144   211   40    100   115   50    77    75    
     43    144   211   40    100   115   50    77    75    
     43    144   211   40    100   115   50    77    75    

bg   29    40    40    34    54    52    48    72    67    
     29    40    41    34    54    53    48    72    67    
     29    40    41    34    54    52    48    72    67    
     29    40    40    34    54    52    48    72    67    

B1   90    100   57    186   191   88    114   134   85    
     90    100   57    185   191   88    114   133   85    
     90    100   57    185   190   88    114   133   85    
     90    100   57    185   190   88    114   133   85    

bg   29    40    40    34    54    52    48    72    67    
     29    40    40    34    54    52    48    72    67    
     29    40    40    34    54    52    48    72    66    
     29    40    40    34    54    52    48    72    66    

B2   71    136   102   122   293   198   87    157   126   
     71    136   102   122   292   198   87    157   126   
     71    136   102   122   291   197   87    157   126   
     71    136   102   122   291   197   87    157   126   

bg   29    40    40    34    54    52    47    72    66    
     29    40    40    34    53    52    47    71    66    
     29    40    40    34    53    52    47    71    66    
     29    40    40    34    53    52    47    71    66    

B3   36    88    109   47    169   229   56    124   147   
     37    88    109   47    169   228   56    124   147   
     37    88    109   47    169   228   56    124   146   
     37    88    108   47    169   228   56    124   146   

bg   29    40    40    34    54    52    47    72    66    
     29    40    40    34    53    52    47    72    66    
     29    40    40    34    54    52    47    72    66    
     29    40    40    34    54    52    47    72    66    

C1   36    47    44    100   115   74    212   227   107   
     36    47    44    100   115   74    212   227   107   
     36    47    44    100   115   74    212   227   107   
     36    47    44    100   115   74    211   226   107   

bg   29    40    40    34    54    52    48    72    66    
     29    40    40    34    53    52    47    71    66    
     29    40    40    34    53    52    47    71    66    
     29    40    40    33    53    52    47    71    66    

C2   34    48    46    73    145   117   151   322   213   
     34    48    46    73    145   117   151   322   213   
     34    48    46    73    145   117   151   321   213   
     34    48    46    73    145   117   150   321   212   

bg   29    40    40    33    53    52    47    71    66    
     29    40    40    33    53    52    47    71    66    
     29    40    40    33    53    52    47    71    66    
     29    40    40    33    53    52    47    71    66    

C3   32    45    47    40    98    123   60    181   241   
     32    45    47    40    99    123   60    181   241   
     32    45    47    40    99    123   60    181   241   
     32    45    47    40    99    123   60    181   240   

bg   29    40    40    33    53    52    47    71    66    
     29    40    40    33    53    52    47    71    66    
     29    40    40    33    53    52    47    71    66    
     29    40    40    34    53    52    47    71    66    


Trial #16-------------------------

     A1    A2    A3    B1    B2    B3    C1    C2    C3    

A1   184   186   78    97    116   70    56    78    70    
     183   185   78    96    115   70    56    78    70    
     182   185   78    96    115   70    56    78    70    
     181   184   78    95    115   69    56    78    70    

bg   29    40    40    33    53    52    47    71    66    
     29    40    40    34    53    52    47    71    66    
     29    40    40    34    54    52    47    72    66    
     29    40    40    34    54    52    48    72    67    

A2   123   270   181   73    150   112   54    81    74    
     123   270   181   73    150   111   54    81    74    
     123   269   181   73    149   111   54    80    74    
     123   269   180   73    149   111   53    80    74    

bg   29    40    40    33    53    52    47    71    66    
     29    40    40    33    53    52    47    71    66    
     29    40    40    33    53    52    47    71    66    
     29    40    40    33    53    52    47    71    66    

A3   43    145   212   40    100   115   50    77    75    
     43    144   211   40    100   115   50    77    75    
     42    144   211   40    100   115   50    77    75    
     42    144   210   40    100   115   50    77    75    

bg   29    40    40    33    53    52    47    71    66    
     29    40    40    33    53    52    47    71    66    
     29    40    40    33    53    52    47    71    66    
     29    40    40    33    53    52    47    71    66    

B1   90    99    56    184   189   87    114   132   84    
     90    99    57    184   189   87    114   132   84    
     90    99    57    184   189   87    113   132   84    
     90    99    56    183   188   87    113   132   84    

bg   29    40    40    33    53    52    47    71    66    
     28    40    40    33    53    52    47    71    66    
     29    40    40    33    53    52    47    71    66    
     28    40    40    33    53    52    47    71    66    

B2   70    135   101   121   291   197   86    156   125   
     70    135   101   121   290   196   86    156   124   
     70    135   101   121   290   196   86    155   124   
     70    135   101   121   289   195   86    155   124   

bg   28    40    40    33    53    52    47    71    66    
     28    40    40    33    53    51    47    71    66    
     28    40    40    33    53    51    47    71    66    
     28    40    40    33    53    52    47    71    66    

B3   36    87    108   46    168   227   56    123   146   
     36    87    108   46    168   227   56    123   145   
     36    87    108   46    167   226   56    123   145   
     36    87    108   46    167   226   56    123   145   

bg   28    40    40    33    53    52    47    71    66    
     28    40    40    33    53    51    47    71    66    
     28    40    40    33    53    51    47    71    66    
     28    40    40    33    53    51    47    71    65    

C1   35    47    44    100   115   73    212   227   107   
     35    47    44    100   115   73    212   226   107   
     35    47    44    99    115   73    211   226   107   
     35    47    44    99    115   73    211   225   106   

bg   28    39    40    33    53    51    47    71    65    
     28    40    40    33    53    51    47    71    66    
     28    40    40    33    53    51    47    71    66    
     28    40    40    33    53    51    47    71    65    

C2   33    48    46    73    144   117   151   322   213   
     33    48    46    73    144   117   150   322   213   
     33    48    46    73    144   117   150   321   212   
     33    48    46    73    144   117   150   321   212   

bg   28    39    40    33    53    51    47    71    65    
     28    39    40    33    53    51    47    71    65    
     28    39    40    33    53    51    47    71    65    
     28    39    40    33    53    51    47    71    65    

C3   31    45    47    40    98    123   59    180   240   
     31    45    47    40    98    123   59    180   240   
     31    45    47    40    98    123   59    180   240   
     31    45    47    40    98    123   59    180   239   

bg   28    40    40    33    53    52    47    71    66    
     28    40    40    33    53    52    47    71    66    
     28    40    40    33    53    51    47    71    66    
     28    40    40    33    53    51    47    71    65    

